# Char  1st Component   2nd Component
丬	冫	丨	# GHJ
乩	占	乚	# GHTJKP
亸	享	单	# G
亿	亻	乙	# GH
仂	亻	力	# GHTJKP
仃	亻	丁	# GHTJKPV
仅	亻	又	# GTP
仆	亻	卜	# GHTJKPV
仉	亻	几	# GHTKPV
仍	亻	乃	# GHTJKPV
从	人	人	# GHTJKP
仗	亻	丈	# GHTJKPV
仞	亻	刃	# GHTJKPV
仟	亻	千	# GHTJKP
仡	亻	乞	# GHTJKP
仨	亻	三	# GHTJK
仪	亻	义	# GH
仫	亻	么	# GHJ
们	亻	门	# G
仳	亻	比	# GHTJKP
仵	亻	午	# GHTJKP
价	亻	介	# GHTJKPV
份	亻	分	# GHTJKPV
仿	亻	方	# GHTJKPV
伈	亻	心	# GHTJKP
伉	亻	亢	# GHTJKP
伋	亻	及	# GHTJKP
优	亻	尤	# GHTK
伙	亻	火	# GHTJKP
伛	亻	区	# GTP
伟	亻	韦	# G
传	亻	专	# G
伢	亻	牙	# GHT
伣	亻	见	# G
伤	亻	𱐩	# G
伥	亻	长	# G
伦	亻	仑	# G
伧	亻	仓	# G
伪	亻	为	# G
伫	亻	㝉	# G
伭	亻	玄	# GHTP
估	亻	古	# GHTJKP
伲	亻	尼	# GHTKPV
伾	亻	丕	# GHTJKP
佁	亻	台	# GHTKP
佖	亻	必	# GHTJKP
佗	亻	它	# GHTJKP
佚	亻	失	# GHTJKPV
佛	亻	弗	# GHTJKPV
佝	亻	句	# GHTJKP
佞	亻	𡚬	# GHTJKPV
佟	亻	冬	# GHTJKP
你	亻	尔	# GHTJKPV
你	亻	尓	# Z
佣	亻	用	# GHTJK
佤	亻	瓦	# GHTJ
佧	亻	卡	# GHT
佩	亻	𫥞	# GHTJKP
佬	亻	老	# GHTJKP
佯	亻	羊	# GHTJKP
佰	亻	百	# GHTJKP
佴	亻	耳	# GHTKP
佶	亻	吉	# GHTJKP
佸	亻	舌	# GHTJKP
佺	亻	全	# GHTJKP
佻	亻	兆	# GHTJKPV
佽	亻	次	# GHTJKP
佾	亻	䏌	# GHTJKP
侁	亻	先	# GHTJKP
侂	亻	㡯	# GHTJKP
侄	亻	至	# GHTJKP
侈	亻	多	# GHTJKPV
侉	亻	夸	# GHTJKP
侏	亻	朱	# GHTJKP
侑	亻	有	# GHTJKP
侔	亻	牟	# GHTJKPV
侗	亻	同	# GHTJKP
侘	亻	宅	# GHTJKPV
侣	亻	吕	# GT
侥	亻	尧	# G
侦	亻	贞	# G
侧	亻	则	# G
侨	亻	乔	# GH
侩	亻	会	# G
侪	亻	齐	# G
侬	亻	农	# G
侹	亻	廷	# GHTJKP
俅	亻	求	# GHTJKP
俍	亻	良	# GHTJKP
俎	仌	且	# GHTJKP
俏	亻	肖	# GHTJKP
俐	亻	利	# GHTJKPV
俑	亻	甬	# GHTJKPV
俘	亻	孚	# GHTJKP
俙	亻	希	# GHTKP
俚	亻	里	# GHTJKPV
俜	亻	甹	# GHTJKP
俟	亻	矣	# GHTJKP
俦	亻	寿	# GJ
俨	亻	严	# G
俩	亻	两	# GT
俪	亻	丽	# G
俫	亻	来	# G
俭	亻	佥	# G
俯	亻	府	# GHTJKPV
俱	亻	具	# GHTKPV
俶	亻	叔	# GHTJKP
俾	亻	卑	# GHTKP
倌	亻	官	# GHTJKP
倓	亻	炎	# GHTJKP
倔	亻	屈	# GHTJKPV
倕	亻	垂	# GHTKP
倘	亻	尚	# GHTV
倘	亻	尙	# JKP
倚	亻	奇	# GHTJKPV
倜	亻	周	# GHTKP
倞	亻	京	# GHTJKP
倡	亻	昌	# GHTJKPV
倥	亻	空	# GHTJKP
倧	亻	宗	# GHTJKP
倨	亻	居	# GHTJKP
倩	亻	青	# GHMTV
倩	亻	靑	# JKP
倪	亻	兒	# GHTJKPV
倬	亻	卓	# GHTJKPV
倮	亻	果	# GHTJKP
倴	亻	奔	# GHT
债	亻	责	# G
倻	亻	耶	# GHJKP
值	亻	直	# GHT
倾	亻	顷	# G
偁	亻	爯	# GHTJKP
偃	亻	匽	# GHTJKPV
假	亻	叚	# GHTJKPV
偈	亻	曷	# GHTJKPV
偌	亻	若	# GHTJKP
偎	亻	畏	# GHTJKPV
偓	亻	屋	# GHTJKP
偕	亻	皆	# GHTJKP
做	亻	故	# GHTJKP
偡	亻	甚	# GHTKP
偬	亻	怱	# GHTJKP
偭	亻	面	# GHTJKP
偰	亻	契	# GHTJKP
偷	亻	俞	# GHTV
偻	亻	娄	# GTPV
偾	亻	贲	# G
偿	亻	尝	# G
傀	亻	鬼	# GHTJKP
傃	亻	素	# GHTJKP
傅	亻	尃	# GHTJKPV
傈	亻	栗	# GHTJ
傉	亻	辱	# T
傒	亻	奚	# GHTJKP
傕	亻	隺	# GHTJKPV
傣	亻	泰	# GHTJ
傥	亻	党	# G
傧	亻	宾	# G
储	亻	诸	# G
傩	亻	难	# G
傲	亻	敖	# GHTJK
傺	亻	祭	# GHTJKP
傻	亻	𡕩	# GHTJKP
僇	亻	翏	# GHTJKP
僎	亻	巽	# GHTJKP
僔	亻	尊	# GHTJKP
僖	亻	喜	# GHTJKP
僦	亻	就	# GHTJKP
僬	亻	焦	# GHTKP
僭	亻	朁	# GHTJKPV
僮	亻	童	# GHTJKPV
僳	亻	粟	# GHTJK
僵	亻	畺	# GHTJKP
儆	亻	敬	# GHTJKP
儇	亻	睘	# GHTJKP
儋	亻	詹	# GHTJKP
儡	亻	畾	# GHTJKP
儦	亻	麃	# GHTKP
儳	亻	毚	# GHTJKPV
儴	亻	襄	# GHTJKP
儿	丿	乚	# GHTJKP
兢	克	克	# GHTJKPV
冁	单	展	# G
冮	冫	工	# GH
冯	冫	马	# G
冰	冫	水	# GHTJKPV
冱	冫	互	# GHTJKP
冲	冫	中	# GHTJKP
决	冫	夬	# GHTJKP
况	冫	兄	# GHTJKPV
冻	冫	东	# G
冼	冫	先	# GHTJK
冽	冫	列	# GHTJKPV
净	冫	争	# GT
凇	冫	松	# GHTP
凉	冫	京	# GHTJKP
减	冫	咸	# GHTJKP
凑	冫	奏	# GHMTJK
凓	冫	栗	# GHTJKP
凘	冫	斯	# GHTJKP
凛	冫	禀	# GHTJKP
几	丿	㇈	# GHTJKPV
凯	岂	几	# G
刂	丨	亅	# GHTJK
刎	勿	刂	# GHTJKPV
划	戈	刂	# GHTJKP
刖	月	刂	# GHTJKP
刘	文	刂	# GTJKP
则	贝	刂	# G
刚	冈	刂	# G
创	仓	刂	# G
删	册	刂	# GV
刨	包	刂	# GHTKPV
别	另	刂	# GT
刬	戋	刂	# G
刭	𢀖	刂	# G
刮	舌	刂	# GHTJKP
刳	夸	刂	# GHTJKP
刹	杀	刂	# GTJKP
刽	会	刂	# GT
刿	岁	刂	# G
剀	岂	刂	# G
剁	朵	刂	# GHT
剂	齐	刂	# G
剅	豆	刂	# GTJK
剌	束	刂	# GHTJKP
剐	呙	刂	# G
剑	佥	刂	# G
剔	易	刂	# GHTJKP
剕	非	刂	# GHTJKP
剜	宛	刂	# GHTJKP
剞	奇	刂	# GHTJKP
剞	竒	刂	# U
剟	叕	刂	# GHTJKP
剡	炎	刂	# GHTJKP
剧	居	刂	# GTV
剩	乘	刂	# GHTJKPV
剽	票	刂	# GHTJKP
剿	巢	刂	# GHTJKPV
劁	焦	刂	# GHTK
劂	厥	刂	# GHTJKPV
劄	答	刂	# GHTJV
劐	蒦	刂	# GHK
劓	鼻	刂	# GHTKP
劝	又	力	# GT
劢	万	力	# G
动	云	力	# GHT
劬	句	力	# GHTJKPV
劭	召	力	# GHTJKP
劲	𢀖	力	# G
劼	吉	力	# GHTJKP
勋	员	力	# G
勍	京	力	# GHTJKP
勐	孟	力	# GHTJK
勒	革	力	# GHTJKPV
勔	面	力	# GTJKP
勖	冒	力	# GHTKP
勚	贳	力	# G
勠	翏	力	# GHTJKP
勰	劦	思	# GHTJKP
勹	㇒	𠃌	# GHTJKP
匏	夸	包	# GHTKPV
协	十	办	# GT
卟	口	卜	# GHT
卧	臣	卜	# GHTJP
卬	？	卩	# GHTJKPV
厶	𠃋	丶	# GHTJKP
叆	云	爱	# G
叇	云	逮	# G
叨	口	刀	# GHTJKPV
叭	口	八	# GHTJKPV
叮	口	丁	# GHTJKPV
叹	口	又	# GT
叻	口	力	# GHTV
叼	口	刁	# GHT
叽	口	几	# GT
吁	口	于	# GHTJKPV
吆	口	幺	# GHTK
吒	口	乇	# GHTJKPV
吓	口	下	# GHTJKV
吖	口	丫	# GHT
吗	口	马	# G
吡	口	比	# GHTJK
吣	口	心	# GHTKV
吧	口	巴	# GHTJKPV
吨	口	屯	# GHTJKPV
吩	口	分	# GHTJKPV
听	口	斤	# GHTJKPV
吭	口	亢	# GHTJKP
吮	口	允	# GHTJKPV
吱	口	支	# GHTJKV
吲	口	引	# GHTPV
吵	口	少	# GHTJKV
吼	口	孔	# GHTJKPV
吽	口	牛	# GHTJKP
呀	口	牙	# GHTJKPV
呃	口	厄	# GHTJKPV
呋	口	夫	# GHTV
呒	口	无	# G
呓	口	艺	# G
呔	口	太	# GHT
呕	口	区	# GJK
呖	口	历	# G
呗	口	贝	# G
呛	口	仓	# G
呜	口	乌	# G
呢	口	尼	# GHTJKPV
呣	口	母	# GHTK
呤	口	令	# GHTJKV
呦	口	幼	# GHTJKPV
呱	口	瓜	# GHTJKPV
呲	口	此	# GHTK
呵	口	可	# GHTJKPV
呶	口	奴	# GHTJKPV
呷	口	甲	# GHTJKP
呸	口	丕	# GHTKPV
呻	口	申	# GHTJKP
咀	口	且	# GHTJKPV
咂	口	匝	# GHTKPV
咄	口	出	# GHTJKPV
咆	口	包	# GHTKPV
咇	口	必	# GHTKP
咉	口	央	# GTJKP
咍	口	台	# GHTJKPV
咏	口	永	# GHTJKPV
咐	口	付	# GHTJKPV
咔	口	卡	# GHT
咕	口	古	# GHTJKP
咖	口	加	# GHTJKP
咙	口	龙	# G
咚	口	冬	# GHTV
咛	口	宁	# G
咝	口	丝	# G
咡	口	耳	# GHTJKP
咣	口	光	# GHTKV
咤	口	宅	# GHTJKP
咥	口	至	# GHTJKPV
咦	口	夷	# GHTJKV
咧	口	列	# GHTJKPV
咩	口	羊	# GHTJK
咪	口	米	# GHTJK
咬	口	交	# GHTJKPV
咭	口	吉	# GHTJKPV
咯	口	各	# GHTJKPV
咱	口	自	# GHTJKP
咴	口	灰	# GHTKV
咺	口	亘	# GHTJKP
咻	口	休	# GHTJKPV
咿	口	伊	# GHTJKPV
哂	口	西	# GHTJKP
哃	口	同	# GHTJKPV
哄	口	共	# GHTJKPV
哆	口	多	# GHTJKPV
哇	口	圭	# GHTJKPV
哈	口	合	# GHTJKPV
哌	口	𠂢	# GHT
响	口	向	# GHTJKPV
哎	口	艾	# GHTJKPV
哏	口	艮	# GHTV
哐	口	匡	# GHT
哑	口	亚	# G
哒	口	达	# G
哓	口	尧	# G
哔	口	毕	# G
哕	口	岁	# G
哗	口	华	# G
哙	口	会	# G
哚	口	朵	# GHT
哜	口	齐	# G
哝	口	农	# G
哞	口	牟	# GHTK
哟	口	约	# G
哢	口	弄	# GHTJKPV
哦	口	我	# GHTJKPV
哧	口	赤	# GHTK
哪	口	那	# GHTJKV
哮	口	孝	# GHTJKPV
哱	口	孛	# GHTJKPV
哳	口	折	# GHTJKPV
哺	口	甫	# GHTJKPV
哼	口	亨	# GHTJK
哽	口	更	# GHTJKPV
唁	口	言	# GHTJKPV
唉	口	矣	# GHTJKPV
唏	口	希	# GHTJKPV
唑	口	坐	# GHTKV
唔	口	吾	# GHTJKP
唛	口	麦	# GT
唝	口	贡	# G
唠	口	劳	# GT
唢	口	𭕆	# G
唣	口	皂	# GH
唤	口	奂	# G
唧	口	即	# GHTK
唪	口	奉	# GHTJKP
唬	口	虎	# GHTKP
唰	口	刷	# GHTK
唳	口	戾	# GHTJKP
唵	口	奄	# GHTJKP
唷	口	育	# GHTKV
唼	口	妾	# GHTJKPV
唿	口	忽	# GHTKP
啁	口	周	# GHTKP
啃	口	肯	# GHTKP
啉	口	林	# GHTJKV
啊	口	阿	# GHTJKV
啐	口	卒	# GHTJKPV
啕	口	匋	# GHTKP
啖	口	炎	# GHTJKP
啜	口	叕	# GHTJKPV
啡	口	非	# GHTJK
啤	口	卑	# GHTK
啥	口	舍	# GHT
啦	口	拉	# GHTJK
啧	口	责	# G
啪	口	拍	# GHTK
啫	口	者	# GHMTKPV
啭	口	转	# G
啮	口	齿	# G
啰	口	罗	# G
啴	口	单	# G
啵	口	波	# GHT
啶	口	定	# GHT
啷	口	郎	# GHTV
啸	口	肃	# G
啼	口	帝	# GHTJKPV
啾	口	秋	# GHTJKP
喀	口	客	# GHTJKP
喁	口	禺	# GHTJKPV
喂	口	畏	# GHTJKPV
喃	口	南	# GHTJKPV
喆	吉	吉	# GHTJKP
喇	口	剌	# GHTJKPV
喈	口	皆	# GHTJKP
喊	口	咸	# GHTJKP
喏	口	若	# GHTJKP
喑	口	音	# GHTJKPV
喔	口	屋	# GHTJKPV
喘	口	耑	# GHTJKPV
喙	口	彖	# GHTJKP
喟	口	胃	# GHTJKPV
喤	口	皇	# GHTJKP
喱	口	厘	# GHTK
喳	口	查	# GHT
喳	口	査	# K
喵	口	苗	# GHTV
喷	口	贲	# G
喹	口	奎	# GHT
喻	口	俞	# GHTV
喽	口	娄	# G
嗄	口	夏	# GHTJKP
嗅	口	臭	# GHTKP
嗉	口	素	# GHTJKPV
嗌	口	益	# GHTJKPV
嗍	口	朔	# GHTK
嗐	口	害	# GHTK
嗑	口	盍	# GHTJKP
嗒	口	荅	# GHTJKP
嗓	口	桑	# GHTJKP
嗔	口	真	# GHTV
嗔	口	眞	# JKP
嗖	口	叟	# GHTK
嗜	口	耆	# GHTJKP
嗝	口	鬲	# GHTJK
嗞	口	兹	# GT
嗞	口	茲	# HJK
嗞	口	玆	# P
嗟	口	差	# GHTJKPV
嗡	口	翁	# GHTKPV
嗤	口	蚩	# GHTJK
嗥	口	皋	# GHTKP
嗦	口	索	# GHT
嗨	口	海	# GHT
嗪	口	秦	# GHT
嗫	口	聂	# G
嗬	口	荷	# GH
嗯	口	恩	# GHT
嗲	口	爹	# GHT
嗳	口	爱	# G
嗵	口	通	# GH
嗷	口	敖	# GHTJK
嗽	口	欶	# GHTJKP
嗾	口	族	# GHTJKP
嘀	口	啇	# GHT
嘁	口	戚	# GHTKV
嘈	口	曹	# GHTJKPV
嘌	口	票	# GHTKP
嘎	口	戛	# GHTJKP
嘏	古	叚	# GHTJKP
嘚	口	得	# GK
嘛	口	麻	# GHTK
嘞	口	勒	# GHTV
嘟	口	都	# GHTKV
嘡	口	堂	# GH
嘣	口	崩	# GH
嘤	口	婴	# G
嘧	口	密	# GHT
嘬	口	最	# GHTJKPV
嘭	口	彭	# GHTK
嘲	口	朝	# GHTJKPV
嘴	口	觜	# GHTJKP
嘶	口	斯	# GHTJKPV
嘹	口	尞	# GHTJKPV
嘻	口	喜	# GHTJKPV
嘿	口	黑	# GHTJKP
噀	口	巽	# GHTJKPV
噇	口	童	# GTJK
噍	口	焦	# GHTJKP
噎	口	壹	# GHTJKPV
噔	口	登	# GHTJKV
噗	口	菐	# GHTK
噘	口	厥	# GHT
噙	口	禽	# GHTKV
噜	口	鲁	# G
噢	口	奥	# G
噢	口	奧	# HTJKP
噤	口	禁	# GHTJKPV
噪	口	喿	# GHTJKPV
噫	口	意	# GHTJKP
噬	口	筮	# GHTJKPV
噱	口	豦	# GHTJKP
噶	口	葛	# GHTJKPV
噻	口	塞	# GHT
噼	口	辟	# GH
嚄	口	蒦	# GHJKPV
嚅	口	需	# GHTJKPV
嚆	口	蒿	# GHTJKPV
嚎	口	豪	# GHTKPV
嚏	口	疐	# GHTJK
嚓	口	察	# GHTKV
嚭	喜	否	# GHTJKP
嚯	口	霍	# GHTKV
嚷	口	襄	# GHTJKV
嚼	口	爵	# GHTKP
囔	口	囊	# GHTK
圢	土	丁	# GHTJK
圩	土	于	# GHTJKPV
圪	土	乞	# GHTJK
圫	土	乇	# GT
圬	土	亏	# GHTJKPV
圮	土	己	# GHTJKPV
圯	土	巳	# GHTJKPV
圲	土	千	# GHT
圳	土	川	# GHTJK
圹	土	广	# G
场	土	𠃓	# G
圻	土	斤	# GHTJKP
圾	土	及	# GHTJKP
址	土	止	# GHTJKPV
坉	土	屯	# GHTKP
坋	土	分	# GHTKPV
坍	土	丹	# GHTJKPV
坎	土	欠	# GHTJKPV
坏	土	不	# GHTJKPV
块	土	夬	# GHT
坛	土	云	# GHT
坜	土	历	# G
坝	土	贝	# G
坞	土	乌	# G
坟	土	文	# GHTV
坡	土	皮	# GHTJKPV
坥	土	且	# GTJK
坨	土	它	# GHTJKP
坩	土	甘	# GHTJKP
坫	土	占	# GHTJKPV
坬	土	瓜	# GT
坭	土	尼	# GHTJKPV
坯	土	丕	# GHTJKPV
坰	土	冋	# GHTJKP
坳	土	幼	# GHTJKP
坶	土	母	# GHTK
坷	土	可	# GHTJKP
坻	土	氐	# GHTJKP
坼	土	斥	# GHTJKP
坽	土	令	# GHTK
垃	土	立	# GHTJKPV
垅	土	龙	# G
垆	土	卢	# GV
垌	土	同	# GHTJKPV
垍	土	自	# GHTKP
垎	土	各	# GTP
垏	土	聿	# GHT
垓	土	亥	# GHTJKPV
垙	土	光	# GHTJK
垛	土	朵	# GHTP
垞	土	宅	# GHTJKP
垟	土	羊	# GHTJKP
垠	土	艮	# GHTJKPV
垤	土	至	# GHTJKP
垧	土	向	# GHTJK
垭	土	亚	# G
垮	土	夸	# GHTKV
垯	土	达	# G
垱	土	当	# G
垲	土	岂	# G
垴	土	㐫	# GHT
垵	土	安	# GHTKV
垸	土	完	# GHTJKP
垺	土	孚	# GHTKP
垾	土	旱	# GHTKP
垿	土	序	# GHT
埂	土	更	# GHTKV
埃	土	矣	# GHTJKPV
埆	土	角	# GHTJKP
埇	土	甬	# GHTJKPV
埌	土	良	# GHTJKP
埏	土	延	# GHTJKP
埒	土	寽	# GHTJK
埔	土	甫	# GHTJK
埕	土	呈	# GHTJKV
埗	土	步	# GHTJ
埗	土	歩	# Z
埘	土	时	# G
埙	土	员	# G
埚	土	呙	# G
埝	土	念	# GHTJKV
埤	土	卑	# GHTKP
埪	土	空	# GT
埫	土	尚	# GT
埭	土	隶	# GHTJKP
埯	土	奄	# GHTP
埵	土	垂	# GHTJKP
埸	土	易	# GHTJKP
埽	土	帚	# GHTJKP
堉	土	育	# GHTJKP
堋	土	朋	# GHTJKP
堌	土	固	# GHTJK
堍	土	兔	# GHTJ
堎	土	夌	# GHT
堐	土	厓	# GHT
堙	土	垔	# GHT
堞	土	枼	# GHTJKPV
堠	土	侯	# GHTJKP
堧	土	耎	# GHTJKP
堨	土	曷	# GHTKP
堽	土	罡	# GHTJK
堾	土	春	# GT
塃	土	荒	# GT
塄	土	𬙙	# GHT
塅	土	段	# GT
塆	土	弯	# G
塌	土	𦐇	# GHTKP
塝	土	旁	# GHTK
塥	土	鬲	# GHTKP
塬	土	原	# GHT
塮	土	射	# GK
墀	土	犀	# GHTJKP
墁	土	曼	# GHTJKPV
墈	土	勘	# GHTJKP
墉	土	庸	# GHTJKP
墐	土	堇	# GHTJKP
墒	土	商	# GHTK
墕	土	焉	# GT
墘	土	乾	# GHT
墙	土	啬	# GH
墚	土	梁	# GHT
增	土	曾	# GHTJKPV
墟	土	虚	# G
墟	土	虛	# HTJKP
墡	土	善	# GHTJKP
墣	土	菐	# GHTKP
墦	土	番	# GHTJKP
墩	土	敦	# GHTJKPV
壤	土	襄	# GHTJKPV
够	句	多	# GHTKP
夥	果	多	# GHTJKPV
奶	女	乃	# GHTJKPV
奸	女	干	# GHTJKPV
她	女	也	# GHTJKP
妁	女	勺	# GHTJKP
妆	丬	女	# GTP
妇	女	𫜹	# G
妈	女	马	# G
妍	女	开	# GHTJKPV
妒	女	户	# GHPV
妒	女	戶	# TJK
妗	女	今	# GHTJKP
妘	女	云	# GHTKP
妞	女	丑	# GHTKP
妣	女	比	# GHTJKP
妤	女	予	# GHTJKP
妧	女	元	# GHTJKP
妩	女	无	# G
妪	女	区	# G
妫	女	为	# G
妭	女	犮	# GTJKP
妮	女	尼	# GHTJKPV
妯	女	由	# GHTJKPV
妲	女	旦	# GHTJKPV
姆	女	母	# GHTJKP
姈	女	令	# GHTJKPV
姊	女	𠂔	# GHTJKPV
姒	女	以	# GHTJKP
姗	女	册	# GTP
姘	女	并	# GHTK
姘	女	幷	# P
姚	女	兆	# GHTJKPV
姝	女	朱	# GHTJKP
姞	女	吉	# GHTJKP
姣	女	交	# GHTJKP
姤	女	后	# GHTJKPV
姨	女	夷	# GHTJKPV
姬	女	𦣞	# GHTP
姬	女	𦣝	# K
姮	女	亘	# GHTJKPV
姱	女	夸	# GHTJK
姹	女	宅	# GHTKP
姽	女	危	# GHTKP
娀	女	戎	# GHTJKP
娅	女	亚	# G
娆	女	尧	# G
娇	女	乔	# G
娉	女	甹	# GHTJKP
娌	女	里	# GHTJKP
娓	女	尾	# GHTJKPV
娜	女	那	# GHTJKPV
娟	女	肙	# GHTJKPV
娣	女	弟	# GHTJKP
娥	女	我	# GHTJKPV
娱	女	吴	# GT
娲	女	呙	# G
娴	女	闲	# G
娵	女	取	# GHTP
婀	女	阿	# GHTJKP
婉	女	宛	# GHTJKPV
婊	女	表	# GHTKP
婌	女	叔	# GHTJKP
婍	女	奇	# GHTKV
婕	女	疌	# GHTJKP
婘	女	卷	# GHTKP
婞	女	幸	# GHTJKP
婠	女	官	# GHTKP
婢	女	卑	# GHTKP
婤	女	周	# GHTK
婧	女	青	# GHT
婧	女	靑	# JKP
婫	女	昆	# GHTP
婳	女	画	# GT
婵	女	单	# GT
婶	女	审	# G
婷	女	亭	# GHTJKP
婻	女	南	# GHTJK
婼	女	若	# GHTKP
媂	女	帝	# GHT
媄	女	美	# GHTJKV
媆	女	耎	# GHTP
媓	女	皇	# GHTJKP
媖	女	英	# GHTJK
媚	女	眉	# GHTJKPV
媞	女	是	# GHTJKP
媪	女	昷	# GHMTKP
媱	女	䍃	# GHTJK
媳	女	息	# GHTJKP
媸	女	蚩	# GHTJK
媾	女	冓	# GHTJKP
嫂	女	叟	# GHTKV
嫄	女	原	# GHTJKP
嫒	女	爱	# G
嫔	女	宾	# G
嫕	女	悘	# GHTKP
嫖	女	票	# GHTJKPV
嫘	女	累	# GHTKP
嫚	女	曼	# GHTJKP
嫜	女	章	# GHTJKP
嫣	女	焉	# GHTJKP
嫦	女	常	# GHTJKPV
嫩	女	敕	# GHTJKPV
嫪	女	翏	# GHTJKP
嫫	女	莫	# GHTKP
嫭	女	虖	# GHTKP
嫱	女	啬	# G
嫽	女	尞	# GHTJKP
嬗	女	亶	# GHTJKP
嬛	女	睘	# GHTJKP
嬥	女	翟	# GHTJKP
嬷	女	麽	# GTKP
嬿	女	燕	# GHTKP
孀	女	霜	# GHTJKPV
孅	女	韱	# GHTJKP
孖	子	子	# GHTJKP
孙	子	小	# G
孢	子	包	# GHTKP
孩	子	亥	# GHTJKPV
孰	享	？	# GHTP
孰	享	丸	# JK[V]
孵	卵	孚	# GHTJKP
孺	子	需	# GHTJKPV
对	又	寸	# GTKPV
尸	丿	？	# GHTJKPV
屹	山	乞	# GHTJKPV
屺	山	己	# GHTJKP
屼	山	兀	# GHTJKP
屾	山	山	# GHTK
屿	山	与	# G
岈	山	牙	# GHTJK
岍	山	开	# GHMTK
岍	山	幵	# P
岖	山	区	# G
岘	山	见	# G
岞	山	乍	# GHTP
岠	山	巨	# GHTJKP
岣	山	句	# GHTJKP
岫	山	由	# GHTJKP
岭	山	令	# GHMTJKP
岵	山	古	# GHTJKPV
岷	山	民	# GHTJKP
峂	山	冬	# GH
峄	山	𠬤	# G
峋	山	旬	# GHTJKP
峒	山	同	# GHTJKP
峗	山	危	# GHTJKP
峘	山	亘	# GHTKP
峙	山	寺	# GHTJKP
峣	山	尧	# G
峤	山	乔	# G
峥	山	争	# GHTK
峧	山	交	# G
峪	山	谷	# GHTJKP
峭	山	肖	# GHTJKP
峿	山	吾	# GHTKP
崂	山	劳	# G
崃	山	来	# G
崄	山	佥	# G
崆	山	空	# GHTJKP
崌	山	居	# GHT
崚	山	夌	# GHTJKP
崛	山	屈	# GHTJKP
崞	山	享	# GHTK
崡	山	函	# GT
崤	山	肴	# GHTJKP
崦	山	奄	# GHTJKP
崾	山	要	# GHT
崿	山	咢	# GHTJK
嵁	山	甚	# GHTKPV
嵊	山	乘	# GHTJKP
嵋	山	眉	# GHTJKPV
嵎	山	禺	# GHTJKPV
嵖	山	查	# GHT
嵘	山	荣	# G
嵝	山	娄	# G
嵫	山	兹	# GT
嵫	山	茲	# HK
嵫	山	玆	# P
嵲	山	臬	# GHTKP
嵴	山	脊	# GHT
嶂	山	章	# GHTJKP
嶍	山	習	# GHTK
嶒	山	曾	# GHTJKP
嶓	山	番	# GHTJKP
嶙	山	粦	# GHTJKP
嶝	山	登	# GHTJKP
嶟	山	尊	# GHTJKPV
嶦	山	詹	# GTKP
巇	山	戲	# GHTJKP
巉	山	毚	# GHTJKP
巩	工	凡	# G
巩	工	？	# T
巩	工	卂	# J
巯	𢀖	㐬	# G
帅	？	巾	# G
师	？	帀	# G
帏	巾	韦	# G
帐	巾	长	# G
帔	巾	皮	# GHTJKP
帕	巾	白	# GHTJKP
帙	巾	失	# GHTJKPV
帜	巾	只	# G
帧	巾	贞	# G
帨	巾	兑	# G
帨	巾	兌	# HTJKP
帱	巾	寿	# G
帷	巾	隹	# GHTJKP
帻	巾	责	# G
帼	巾	国	# G
幄	巾	屋	# GHTJKP
幔	巾	曼	# GHTJKPV
幖	巾	票	# GTJKP
幛	巾	章	# GHTJKV
幞	巾	菐	# GHTJKP
幢	巾	童	# GHTJKPV
幪	巾	蒙	# GHTJKV
幪	巾	𫎇	# P
弑	杀	式	# GTJKPV
张	弓	长	# G
弢	弓	𠬢	# GHTJKP
弨	弓	召	# GHTJKP
弪	弓	𢀖	# G
弭	弓	耳	# GHTJKPV
弶	弓	京	# GHTJKP
弸	弓	朋	# GHTJKP
弹	弓	单	# GT
强	弓	虽	# GHTKP
归	？	𫜹	# GP
彟	寻	蒦	# G
彤	丹	彡	# GHTJKP
彭	壴	彡	# GHTJKPV
彷	彳	方	# GHTJKPV
彻	彳	切	# GH
徂	彳	且	# GHTJKPV
徇	彳	旬	# GHTJKP
很	彳	艮	# GHTJKP
徉	彳	羊	# GHTJKP
徊	彳	回	# GHTJKPV
徕	彳	来	# G
徘	彳	非	# GHTJKPV
徙	彳	歨	# GHTJKP
徛	彳	奇	# GHTK
徜	彳	尚	# GHT
徜	彳	尙	# JKP
徨	彳	皇	# GHTJKPV
徭	彳	䍃	# GHTJKP
徵	彳	𢽠	# GHTJKPV
德	彳	𢛳	# GHTJKPV
徼	彳	敫	# GHTJKP
忆	忄	乙	# GV
忉	忄	刀	# GHTJKPV
忏	忄	千	# GHTKV
忖	忄	寸	# GHTJKPV
忡	忄	中	# GHTJKP
忤	忄	午	# GHTJKPV
忧	忄	尤	# GT
忪	忄	公	# GHTJKP
忭	忄	卞	# GHTJKP
忮	忄	支	# GHTJKP
忱	忄	冘	# GHTJKPV
忳	忄	屯	# GHTJKP
忸	忄	丑	# GHTJKPV
忺	忄	欠	# GHTJKP
忻	忄	斤	# GHTJKP
忾	忄	气	# G
怀	忄	不	# GHTK
怃	忄	无	# G
怄	忄	区	# G
怅	忄	长	# G
怆	忄	仓	# G
怊	忄	召	# GHTJKP
怍	忄	乍	# GHTJKPV
怏	忄	央	# GHTJKP
怔	忄	正	# GHTJKP
怕	忄	白	# GHTJKP
怙	忄	古	# GHTJKP
怛	忄	旦	# GHTJKPV
怡	忄	台	# GHTJKP
怦	忄	平	# GHTJKPV
怩	忄	尼	# GHTJKPV
怫	忄	弗	# GHTJKPV
怵	忄	术	# GPV
怵	忄	朮	# HTJK
怿	忄	𠬤	# G
恂	忄	旬	# GHTJKP
恃	忄	寺	# GHTJKP
恍	忄	光	# GHTJKPV
恓	忄	西	# GHTKP
恔	忄	交	# GHTJKP
恤	忄	血	# GHTJKP
恪	忄	各	# GHTJKPV
恫	忄	同	# GHTJKP
恬	忄	舌	# GHTJKPV
恸	忄	动	# G
恹	忄	厌	# G
恺	忄	岂	# G
恻	忄	则	# G
恼	忄	㐫	# GT
恽	忄	军	# G
悃	忄	困	# GHTJKP
悄	忄	肖	# GHTJKPV
悈	忄	戒	# GHTJKP
悍	忄	旱	# GHTJKPV
悒	忄	邑	# GHTJKP
悖	忄	孛	# GHTJKPV
悚	忄	束	# GHTJKP
悛	忄	夋	# GHTJKPV
悝	忄	里	# GHTJKP
悢	忄	良	# GHTJKP
悭	忄	坚	# GV
悯	忄	闵	# G
悰	忄	宗	# GHTJKP
悱	忄	非	# GHTJKPV
悴	忄	卒	# GHTJKPV
悸	忄	季	# GHTJKP
悻	忄	幸	# GHTJKPV
惆	忄	周	# GHTKP
惊	忄	京	# GHTJKV
惋	忄	宛	# GHTJKP
惔	忄	炎	# GHTJKP
惕	忄	易	# GHTJKPV
惘	忄	罔	# GHTJKP
惙	忄	叕	# GHTJKP
惛	忄	昏	# GHTJKPV
惝	忄	尚	# GHTV
惝	忄	尙	# JKP
惦	忄	店	# GHTKV
惧	忄	具	# GHTKP
惭	忄	斩	# G
惮	忄	单	# GT[V]
惮	忄	単	# J
惯	忄	贯	# G
惴	忄	耑	# GHTJKPV
惶	忄	皇	# GHTJKPV
惺	忄	星	# GHTJKP
愀	忄	秋	# GHTJKPV
愃	忄	宣	# GHTJKP
愎	忄	复	# GHTJKPV
愐	忄	面	# GHTJKV
愔	忄	音	# GHTJKP
愕	忄	咢	# GHTJKV
愠	忄	昷	# GHMT
愣	忄	𬙙	# GHTK
愤	忄	贲	# G
愦	忄	贵	# G
愧	忄	鬼	# GHTJKP
愫	忄	素	# GHTJKP
愭	忄	耆	# GTKP
慆	忄	舀	# GHTJKPV
慊	忄	兼	# GHTJKP
慑	忄	聂	# G
慥	忄	造	# GHTJKP
慬	忄	堇	# GHTJKPV
慵	忄	庸	# GHTJKPV
慷	忄	康	# GHTJKPV
憔	忄	焦	# GHTJKPV
憕	忄	登	# GHTP
憬	忄	景	# GHTJKP
憭	忄	尞	# GHTJKPV
憷	忄	楚	# GHTKP
憺	忄	詹	# GHTJKPV
懂	忄	董	# GHTJKP
懈	忄	解	# GHTJKP
懊	忄	奥	# GV
懊	忄	奧	# HTJKP
懒	忄	赖	# G
懔	忄	禀	# G
懦	忄	需	# GHTJKPV
懵	忄	瞢	# GHTJKP
懿	壹	恣	# GHTJKP
戏	又	戈	# GT
戕	爿	戈	# GHTJKP
戗	仓	戈	# G
战	占	戈	# GTKP
戡	甚	戈	# GHTJKP
戢	咠	戈	# HTJP[V]
戣	癸	戈	# GHTJKP
戤	盈	戈	# GHTKP
戥	星	戈	# GHTK
戬	晋	戈	# GHT
戭	寅	戈	# GHTKP
戮	翏	戈	# GHTJKP
戳	翟	戈	# GHTJKP
扎	扌	乚	# GHTJKPV
扑	扌	卜	# GHTJKPV
扒	扌	八	# GHTJKPV
扔	扌	乃	# GHTJKPV
扛	扌	工	# GHTJKPV
扞	扌	干	# GHTJKP
扣	扌	口	# GHTJKPV
扦	扌	千	# GHTKPV
执	扌	？	# G[M][B]
执	扌	丸	# Z
扩	扌	广	# G
扪	扌	门	# G
扫	扌	𫜹	# G
扬	扌	𠃓	# G
扭	扌	丑	# GHTJKP
扯	扌	止	# GHTJKPV
扰	扌	尤	# GHTK
扳	扌	反	# GHTJKPV
扺	扌	氏	# GHTJKPV
扼	扌	厄	# GHTJKPV
扽	扌	屯	# GHTJKPV
找	扌	戈	# GHTJKPV
抃	扌	卞	# GHTJKPV
抉	扌	夬	# GHTJKPV
抒	扌	予	# GHTJKPV
抓	扌	爪	# GHTJKPV
抔	扌	不	# GHTJKPV
抖	扌	斗	# GHTJKPV
抚	扌	无	# GTP
抛	扌	𠠵	# GTJKPV
抟	扌	专	# G
抠	扌	区	# G
抡	扌	仑	# G
抢	扌	仓	# G
护	扌	户	# GH
护	扌	戶	# T
报	扌	𠬝	# GT
抨	扌	平	# GHTJKPV
抬	扌	台	# GHTJK
抻	扌	申	# GHTJKP
抿	扌	民	# GHTJK
拂	扌	弗	# GHTJKPV
拃	扌	乍	# GHTP
拄	扌	主	# GHTJKPV
拆	扌	斥	# GHTJKPV
拇	扌	母	# GHTJKP
拈	扌	占	# GHTJKPV
拉	扌	立	# GHTJKPV
拊	扌	付	# GHTJKP
拌	扌	半	# GHTKPV
拎	扌	令	# GHTJKP
拔	扌	犮	# GHTJKP
拖	扌	㐌	# GHTJKPV
拗	扌	幼	# GHTJKPV
拚	扌	弁	# GHTJKP
拟	扌	以	# GHTP
拢	扌	龙	# G
拣	扌	𫠣	# G
拤	扌	卡	# GT
拥	扌	用	# GHV
拦	扌	兰	# G
拧	扌	宁	# GV
拨	扌	发	# GV
择	扌	𠬤	# G
拮	扌	吉	# GHTJKPV
拯	扌	丞	# GHTJKPV
拱	扌	共	# GHTJKPV
拴	扌	全	# GHTJKP
拼	扌	并	# GHTJKPV
拼	扌	幷	# Z
拽	扌	曳	# GHTJKPV
挂	扌	圭	# GHTJKPV
挎	扌	夸	# GHTKP
挓	扌	宅	# GHTJKP
挖	扌	穵	# GHTJKP
挝	扌	过	# G
挞	扌	达	# G
挠	扌	尧	# G
挡	扌	当	# GT
挢	扌	乔	# G
挣	扌	争	# GT
挤	扌	齐	# G
挥	扌	军	# G
挦	扌	寻	# G
挪	扌	那	# GHTJKPV
挹	扌	邑	# GHTJKPV
捂	扌	吾	# GHTJKP
捃	扌	君	# GHTJKPV
捅	扌	甬	# GHTKPV
捆	扌	困	# GHTJKP
捋	扌	寽	# GHTJK
捍	扌	旱	# GHTJKPV
捎	扌	肖	# GHTJKP
捏	扌	圼	# GHTJKP
捐	扌	肙	# GHTJKPV
捞	扌	劳	# G
损	扌	员	# G
捡	扌	佥	# G
换	扌	奂	# G
捣	扌	岛	# G
捩	扌	戾	# GHTJKP
捭	扌	卑	# GHTKP
捯	扌	到	# GHTK
捱	扌	厓	# GHTJKPV
捶	扌	垂	# GHTJKP
捽	扌	卒	# GHTJKPV
掀	扌	欣	# GHTJKP
掂	扌	店	# GHTJKPV
掇	扌	叕	# GHTJKPV
掉	扌	卓	# GHTJKPV
掊	扌	咅	# GHTJKP
掎	扌	奇	# GHTJKP
掏	扌	匋	# GHTJKPV
掐	扌	臽	# GHTJKP
掖	扌	夜	# GHTJKP
掞	扌	炎	# GHTJKP
掭	扌	忝	# GHTJK
掮	扌	肩	# GHTJKV
掳	扌	虏	# G
掷	扌	郑	# GV
掸	扌	单	# GV
掺	扌	参	# GT
掼	扌	贯	# G
掾	扌	彖	# GHTJKP
揄	扌	俞	# GHT
揄	扌	兪	# JKP
揆	扌	癸	# GHTJKPV
揉	扌	柔	# GHTJKP
揍	扌	奏	# GHTKP
揎	扌	宣	# GHTJKP
插	扌	臿	# GHTJKPV
揕	扌	甚	# GHTJKPV
揞	扌	音	# GHTKPV
揠	扌	匽	# GHTJKP
揣	扌	耑	# GHTJKP
揩	扌	皆	# GHTJKPV
揪	扌	秋	# GHTJKP
揭	扌	曷	# GHTJKPV
揲	扌	枼	# GHTJKPV
揳	扌	契	# GHTJKPV
揶	扌	耶	# GHTJKP
揸	扌	查	# GHT
揸	扌	査	# JK
揽	扌	览	# G
揾	扌	昷	# GHTPV
揿	扌	钦	# G
搀	扌	𫥎	# G
搁	扌	阁	# G
搂	扌	娄	# G
搅	扌	觉	# G
搋	扌	虒	# GHTKP
搌	扌	展	# GHTKPV
搏	扌	尃	# GHTJKPV
搐	扌	畜	# GHTJKP
搒	扌	旁	# GHTJKP
搓	扌	差	# GHTJKPV
搔	扌	蚤	# GHTJKPV
搛	扌	兼	# GHTKV
搜	扌	叟	# GHTKPV
搞	扌	高	# GHTJKV
搠	扌	朔	# GHTJKP
搡	扌	桑	# GHTKP
搦	扌	弱	# GHTJKP
搪	扌	唐	# GHTJKP
搽	扌	茶	# GHTJKP
摁	扌	恩	# GHTK
摄	扌	聂	# G
摅	扌	虑	# G
摆	扌	罢	# GT
摈	扌	宾	# G
摊	扌	难	# G
摏	扌	舂	# GTJK
摒	扌	屏	# GHTP
摒	扌	屛	# JK
摔	扌	率	# GHTP
摛	扌	离	# GHTJKPV
摞	扌	累	# GHTKP
摧	扌	崔	# GHTJKP
摭	扌	庶	# GHTJKP
摴	扌	雩	# GHTJK
摽	扌	票	# GHTJKPV
撂	扌	畧	# GHTK
撄	扌	婴	# G
撅	扌	厥	# GHTJKPV
撇	扌	敝	# GHTJKP
撑	扌	掌	# GHTJKPV
撕	扌	斯	# GHTJKP
撖	扌	敢	# GHTK
撙	扌	尊	# GHTJKP
撩	扌	尞	# GHTJKPV
撬	扌	毳	# GHTJKP
撵	扌	辇	# G
撷	扌	颉	# G
撸	扌	鲁	# G
撺	扌	窜	# G
撼	扌	感	# GHTJKPV
擀	扌	幹	# GHTPV
擂	扌	雷	# GHTJKPV
擅	扌	亶	# GHTJKPV
擐	扌	睘	# GHTJKP
擒	扌	禽	# GHTJKPV
擗	扌	辟	# GHTJKPV
擞	扌	数	# G
擤	扌	鼻	# GHTKPV
擿	扌	適	# GHTJKP
攉	扌	霍	# GHTJKPV
攒	扌	赞	# G
攘	扌	襄	# GHTJKPV
攥	扌	纂	# GHTKP
攫	扌	矍	# GHTJKP
攮	扌	囊	# GHTJKPV
收	丩	攵	# GHTJKPV
攽	分	攵	# GHTJKP
效	交	攵	# GHTJKPV
敉	米	攵	# GHTJKP
敔	吾	攵	# GHTJKP
敖	𫠤	攵	# G
敛	佥	攵	# G
敝	㡀	攵	# GHTV[B]
敝	㡀	攵	# JKP[S]
敞	尙	攵	# JKP
斓	文	阑	# G
斛	角	斗	# GHTJKPV
斟	甚	斗	# GHTJKPV
斠	冓	斗	# GHTJKP
斩	车	斤	# G
斫	石	斤	# GHTJKPV
斶	斤	蜀	# GHTK
旰	日	干	# GHTJK
旴	日	于	# GHTJKPV
时	日	寸	# GTPV
旷	日	广	# G
旸	日	𠃓	# G
旿	日	午	# GHTJKP
昀	日	匀	# GP
昀	日	勻	# HTJK
昄	日	反	# GHTJKP
昈	日	户	# GHP
昈	日	戶	# TJK
昉	日	方	# GHTJKP
昒	日	勿	# GHTJKP
昕	日	斤	# GHTJKP
昡	日	玄	# GHTJKP
昣	日	㐱	# GHTJKP
昤	日	令	# GHTJKP
昫	日	句	# GHTJKP
昳	日	失	# GHTJKP
昵	日	尼	# GHTJKP
昽	日	龙	# G
晅	日	亘	# GHTJKP
晊	日	至	# GHTJKP
晌	日	向	# GHTJKP
晐	日	亥	# GTKP
晔	日	华	# G
晖	日	军	# G
晗	日	含	# GHTJKP
晙	日	夋	# GHTJKP
晚	日	免	# GHTP
晞	日	希	# GHTJKP
晡	日	甫	# GHTJKP
晤	日	吾	# GHTJKPV
晪	日	典	# GHTJK
晫	日	卓	# GHTJKP
晰	日	析	# GHTJKP
晱	日	炎	# GHTK
晾	日	京	# GHTJKP
暄	日	宣	# GHTJKPV
暅	日	恆	# P
暌	日	癸	# GHTJKP
暕	日	柬	# GHTKP
暝	日	冥	# GHTJKP
暧	日	爱	# G
暲	日	章	# GHTJKP
暵	日	𦰩	# GHTJKP
暶	日	旋	# GHTKP
暾	日	敦	# GHTJKP
暿	日	喜	# GHTJKP
曈	日	童	# GHTJKP
曛	日	熏	# GHTJKP
曦	日	羲	# GHTJKP
朦	月	𫎇	# P
朳	木	八	# GHTJKP
朸	木	力	# GHTJKP
权	木	又	# G
杄	木	千	# GHTPV
杆	木	干	# GHTJKPV
杈	木	叉	# GHTJKP
杌	木	兀	# GHTJKP
杕	木	大	# GHTJKPV
杙	木	弋	# GHTJKP
杞	木	己	# GHTJKP
杠	木	工	# GHTJKPV
杧	木	亡	# GH
杨	木	𠃓	# G
杩	木	马	# G
杪	木	少	# GHTJKP
杻	木	丑	# GHTJKP
杼	木	予	# GHTJKP
极	木	及	# GHTJKP
构	木	勾	# GHTJKP
枅	木	开	# GHTJKP
枉	木	王	# GHTJKPV
枋	木	方	# GHTJKP
枍	木	兮	# GHTK
枘	木	内	# GV
枘	木	內	# HTJKP
枞	木	从	# GTP
枥	木	历	# G
枧	木	见	# G
枨	木	长	# G
枪	木	仓	# G
枫	木	风	# G
枰	木	平	# GHTJKP
枳	木	只	# GHTJKP
枵	木	号	# GHTJKPV
枷	木	加	# GHTJKPV
枸	木	句	# GHTJKPV
枹	木	包	# GHTKP
柃	木	令	# GHTJKPV
柈	木	半	# GHTKP
柖	木	召	# GHTKP
柙	木	甲	# GHTJKP
柜	木	巨	# GHTJKP
柝	木	斥	# GHTJKP
柞	木	乍	# GHTJKP
柠	木	宁	# GTKP
柢	木	氐	# GHTJKP
柩	木	匛	# GHTJKPV
柯	木	可	# GHTJKP
柷	木	兄	# GHTJKP
柽	木	圣	# G
栀	木	卮	# GHT
栅	木	册	# GTKP
标	木	示	# G
栈	木	戋	# G
栉	木	节	# G
栊	木	龙	# G
栋	木	东	# G
栌	木	卢	# G
栎	木	乐	# G
栏	木	兰	# G
栐	木	永	# GHTJKPV
树	木	对	# GT
栒	木	旬	# GHTKP
栝	木	舌	# GHTJKP
栟	木	并	# GHTJKP
栟	木	幷	# Z
栩	木	羽	# GHTJKP
栲	木	考	# GHTJKP
栳	木	老	# GHTJKP
样	木	羊	# GHT
栻	木	式	# GHTJKP
桄	木	光	# GHTJKPV
桅	木	危	# GHTJKP
框	木	匡	# GHTJKP
桉	木	安	# GHTJKP
桎	木	至	# GHTJKPV
桕	木	臼	# GHTJKP
桠	木	亚	# G
桡	木	尧	# G
桢	木	贞	# G
档	木	当	# GJ
桤	木	岂	# G
桥	木	乔	# GH
桦	木	华	# G
桩	木	庄	# G
桫	木	沙	# GHTJK
桯	木	呈	# GHTJK
桲	木	孛	# GHTJKPV
桴	木	孚	# GHTJKP
桷	木	角	# GHTJKPV
桹	木	良	# GHTJKP
梃	木	廷	# GHTJKP
梆	木	邦	# GHTJKPV
梌	木	余	# GHTKPV
梏	木	告	# GTKPV
梏	木	吿	# HJ
梠	木	吕	# G
梠	木	呂	# HTJKP
梣	木	岑	# GHTJKP
梭	木	夋	# GHTJKPV
梳	木	㐬	# GHTJKPV
梴	木	延	# GHTJKP
梽	木	志	# GHT
梾	木	来	# G
梿	木	连	# G
检	木	佥	# G
棂	木	灵	# GV
棍	木	昆	# GHTJKPV
棓	木	咅	# GHTJKP
棕	木	宗	# GHTJKP
棘	朿	朿	# GHTJKPV
棣	木	隶	# GHTJKP
棤	木	昔	# GHTJKP
棪	木	炎	# GHTJKP
棫	木	或	# GHTJKP
棬	木	卷	# GHTJKP
棰	木	垂	# GHTJKP
棱	木	夌	# GHTJKPV
棵	木	果	# GHTJKPV
棹	木	卓	# GHTJKPV
椁	木	享	# GHTJKP
椆	木	周	# GHTKP
椐	木	居	# GHTJKP
椑	木	卑	# GHTKP
椒	木	叔	# GHTJKPV
椓	木	豖	# GHTJKP
椟	木	卖	# G
椤	木	罗	# G
椪	木	並	# GHTJK
椭	木	陏	# G
椰	木	耶	# GHTJKPV
椸	木	施	# GHTJKP
椹	木	甚	# GHTJKPV
椽	木	彖	# GHTJKP
楂	木	查	# GHTKP
楂	木	査	# J
楒	木	思	# GHTK
楔	木	契	# GHTJKP
楗	木	建	# GHTJKP
楝	木	柬	# GHTJKP
楞	木	𬙙	# GHTJKP
楣	木	眉	# GHTJKPV
楦	木	宣	# GHTJKP
楩	木	便	# GHTJKP
楪	木	枼	# GHTJKP
楫	木	咠	# GHTJKP
楮	木	者	# GHTKPV
楱	木	奏	# GHTJKPV
楷	木	皆	# GHTJKP
楸	木	秋	# GHTJKP
楹	木	盈	# GHTJKP
榀	木	品	# GHTJK
榄	木	览	# G
榅	木	昷	# GHT
榆	木	俞	# GHT
榇	木	亲	# G
榈	木	闾	# G
榉	木	举	# G
榍	木	屑	# GHTJKP
榑	木	尃	# GHTJKP
榕	木	容	# GHTJKP
榜	木	旁	# GHTJKPV
榧	木	匪	# GHTJKP
榨	木	窄	# GHTJKP
榫	木	隼	# GHTJKP
榭	木	射	# GHTJKPV
榰	木	耆	# GHTJKP
榱	木	衰	# GHTJKPV
榴	木	留	# GHTJKPV
榷	木	隺	# GHTJKP
榻	木	𦐇	# GHTP
槁	木	高	# GHTJKPV
槎	木	差	# GHTJKPV
槐	木	鬼	# GHTJKPV
槔	木	皋	# GHTPV
槚	木	贾	# G
槛	木	监	# G
槜	木	隽	# G
槟	木	宾	# G
槠	木	诸	# G
槭	木	戚	# GHTJKP
槲	木	斛	# GHTJKP
槿	木	堇	# GHTJKP
樘	木	堂	# GHTKP
樨	木	犀	# GHTJKP
樯	木	啬	# G
樱	木	婴	# G
樾	木	越	# GHTJKPV
橄	木	敢	# GHTJKPV
橇	木	毳	# GHTJKP
橑	木	尞	# GHTJKPV
橙	木	登	# GHTJKPV
橛	木	厥	# GHTJKPV
橞	木	惠	# GHTK
橦	木	童	# GHTJKP
橱	木	厨	# GHTJKP
橹	木	鲁	# G
橼	木	缘	# G
檄	木	敫	# GHTJKPV
檐	木	詹	# GHTJKP
檑	木	雷	# GHTJKPV
檞	木	解	# GHTJKP
檩	木	禀	# G
檫	木	察	# GHTJK
檬	木	蒙	# GHTJKPV
檵	木	㡭	# GHTKP
櫆	木	魁	# GHTJK
欂	木	薄	# GHTJKP
欢	又	欠	# GTP
欤	与	欠	# GTJ
欷	希	欠	# GHTJKP
欸	矣	欠	# GHTJKP
欹	奇	欠	# GHTJKP
欻	炎	欠	# GHTJKP
歃	臿	欠	# GHTJKP
歅	垔	欠	# GHTK
歆	音	欠	# GHTJKPV
歇	曷	欠	# GHTJKPV
歉	兼	欠	# GHTJKP
歙	翕	欠	# GHTJKP
歧	止	支	# GHTJKP
歼	歹	千	# G
殁	歹	殳	# GHTJP
殂	歹	且	# GHTJKPV
殃	歹	央	# GHTJKPV
殄	歹	㐱	# GHTJKP
殍	歹	孚	# GHTJKPV
殒	歹	员	# G
殓	歹	佥	# G
殚	歹	单	# G
殛	歹	亟	# GHTJKP
殡	歹	宾	# GT
殣	歹	堇	# GHTJKP
殪	歹	壹	# GHTJKPV
殷	㐆	殳	# GHTJKPV
毁	𬛸	殳	# GHTKPV
毓	每	㐬	# GHTJKP
毗	田	比	# GHTJKP
毵	参	毛	# GT
毹	俞	毛	# GHT
毹	兪	毛	# JKP
氍	瞿	毛	# GHTJKP
氓	亡	民	# GHTJKPV
氿	氵	九	# GHTJKP
汇	氵	匚	# G
汈	氵	刁	# G
汉	氵	又	# GHT
汊	氵	叉	# GHTJKPV
汋	氵	勺	# GHTKP
汔	氵	乞	# GHTJKPV
汕	氵	山	# GHTJKPV
汛	氵	卂	# GHV
汜	氵	巳	# GHTJKPV
污	氵	亏	# GHTPV
汤	氵	𠃓	# G
汧	氵	开	# GHMTP
汧	氵	幵	# JK
汨	氵	日	# GHTJKPV
汩	氵	曰	# GHKP
汩	氵	日	# T
汪	氵	王	# GHTJKP
汫	氵	井	# GHTJKV
汭	氵	内	# G
汭	氵	內	# HTJKP
汴	氵	卞	# GHTJKP
汶	氵	文	# GHTJKP
汹	氵	凶	# GHTJKP
汾	氵	分	# GHTJKP
沁	氵	心	# GHTJKPV
沂	氵	斤	# GHTJKP
沄	氵	云	# GHTJKP
沅	氵	元	# GHTJKP
沆	氵	亢	# GHTJKP
沇	氵	允	# GHTJKP
沉	氵	冗	# GHTJKPV
沏	氵	切	# GHTKP
沐	氵	木	# GHTJKPV
沔	氵	丏	# GHTJKPV
沔	氵	丐	# Z
沘	氵	比	# GHTJKP
沚	氵	止	# GHTJKPV
沛	氵	巿	# GHTJPV
沛	氵	市	# K
沟	氵	勾	# GHTJKP
沣	氵	丰	# GT
沤	氵	区	# G
沥	氵	历	# G
沦	氵	仑	# G
沧	氵	仓	# G
沨	氵	风	# G
沩	氵	为	# G
沪	氵	户	# GHP
沪	氵	戶	# T
沪	氵	戸	# J
沭	氵	术	# GP
沭	氵	朮	# HTJK
沮	氵	且	# GHTJKP
沱	氵	它	# GHTJKPV
沲	氵	㐌	# GHTJKPV
沺	氵	田	# GHTJKP
沽	氵	古	# GHTJKP
沾	氵	占	# GHTJKPV
泂	氵	冋	# GHTJKP
泃	氵	句	# GHTKP
泄	氵	世	# GHTJKPV
泅	氵	囚	# GHTJKPV
泇	氵	加	# GHTK
泐	氵	阞	# GHTJKP
泓	氵	弘	# GHTJKP
泔	氵	甘	# GHTJKP
泖	氵	卯	# GHTJKV
泗	氵	四	# GHTJKPV
泙	氵	平	# GHTJKPV
泚	氵	此	# GHTJKP
泛	氵	乏	# GHTJKPV
泜	氵	氐	# GHTJKPV
泞	氵	宁	# GHTKPV
泠	氵	令	# GHTJKPV
泪	氵	目	# GHTJKPV
泫	氵	玄	# GHTJKP
泮	氵	半	# GHTKPV
泯	氵	民	# GHTJKP
泱	氵	央	# GHTJKP
泷	氵	龙	# G
泸	氵	卢	# G
泺	氵	乐	# G
泻	氵	写	# GJ
泼	氵	发	# G
泽	氵	𠬤	# G
泾	氵	𢀖	# G
洁	氵	吉	# GHTKV
洄	氵	回	# GHTJKPV
洇	氵	因	# GHTJKP
洈	氵	危	# GHTK
洌	氵	列	# GHTJKPV
洎	氵	自	# GHTJKP
洑	氵	伏	# GHTJKP
洒	氵	西	# GHTJKPV
洓	氵	朿	# GTJKP
洘	氵	考	# GHTKPV
洙	氵	朱	# GHTJKPV
洚	氵	夅	# GHTJKP
洢	氵	伊	# GHTKP
洣	氵	米	# GTKPV
洧	氵	有	# GHTJKP
洨	氵	交	# GHTJKP
洫	氵	血	# GHTJKP
洭	氵	匡	# GHTK
洮	氵	兆	# GHTJKPV
洱	氵	耳	# GHTJKP
洳	氵	如	# GHTJKPV
洴	氵	并	# GHTP
洴	氵	幷	# JK
洵	氵	旬	# GHTJKP
洸	氵	光	# GHTJKP
洹	氵	亘	# GHTJKP
洺	氵	名	# GHTKP
洼	氵	圭	# GHTJKP
洽	氵	合	# GHTJKP
洿	氵	夸	# GHTJKP
浃	氵	夹	# GT
浇	氵	尧	# G
浈	氵	贞	# G
浉	氵	师	# G
浊	氵	虫	# G
测	氵	则	# G
浍	氵	会	# G
济	氵	齐	# GHP
浏	汶	刂	# G
浐	氵	产	# G
浑	氵	军	# G
浒	氵	许	# G
浓	氵	农	# G
浔	氵	寻	# G
浕	氵	尽	# G
浙	氵	折	# GHTJKP
浚	氵	夋	# GHTJKP
浛	氵	含	# GHTJKP
浞	氵	足	# GHTJKP
浟	氵	攸	# GHTJKP
浠	氵	希	# GHTJKPV
浡	氵	孛	# GHTJKPV
浣	氵	完	# GHTJKP
浥	氵	邑	# GHTJKPV
浭	氵	更	# GHTKP
浯	氵	吾	# GHTJKP
浰	氵	利	# GHTJKPV
浲	氵	夆	# GHTKP
浼	氵	免	# GHTKP
涂	氵	余	# GHTJKPV
涄	氵	甹	# GHTK
涅	氵	圼	# GHTJKPV
涉	氵	步	# GHTJKPV
涍	氵	孝	# GHTJKP
涎	氵	延	# GHTJKP
涐	氵	我	# GHTKP
涑	氵	束	# GHTJKP
涓	氵	肙	# GHTJKPV
涔	氵	岑	# GHTJKP
涕	氵	弟	# GHTJKP
涘	氵	矣	# GHTJKP
涝	氵	劳	# G
涞	氵	来	# G
涟	氵	连	# G
涠	氵	围	# G
涡	氵	呙	# G
涢	氵	员	# G
涣	氵	奂	# G
涤	氵	条	# GHK
润	氵	闰	# G
涧	氵	间	# G
涨	氵	张	# G
涩	氵	𰙜	# G
涪	氵	咅	# GHTJKP
涫	氵	官	# GHTJKP
涮	氵	刷	# GHTJKP
涴	氵	宛	# GHTJKP
涵	氵	函	# GHTJKP
涸	氵	固	# GHTJKPV
涿	氵	豖	# GHTJKP
淄	氵	甾	# GHTJKP
淅	氵	析	# GHTJKP
淆	氵	肴	# GHTJKP
淇	氵	其	# GHTJKP
淌	氵	尚	# GHT
淌	氵	尙	# JKP
淏	氵	昊	# GHTJKP
淖	氵	卓	# GHTJKPV
淙	氵	宗	# GHTJKP
淜	氵	朋	# GHTKP
淝	氵	肥	# GHTJKPV
淞	氵	松	# GHTJKP
淟	氵	典	# GHTJKPV
淠	氵	畀	# GHTJKP
淤	氵	於	# GHTJKPV
淦	氵	金	# GHTJKP
淬	氵	卒	# GHTJKPV
淮	氵	隹	# GHTJKPV
淯	氵	育	# GHTJKPV
淴	氵	忽	# GHTJKP
淹	氵	奄	# GHTJKPV
渊	氵	𫂱	# GHTJP
渌	氵	录	# GT
渍	氵	责	# G
渎	氵	卖	# G
渐	氵	斩	# G
渑	氵	黾	# G
渔	氵	鱼	# G
渖	氵	审	# G
渗	氵	参	# GTJK
渝	氵	俞	# GHT
渝	氵	兪	# JK
渟	氵	亭	# GHTJKP
渣	氵	查	# GHTP
渣	氵	査	# JK
渤	氵	勃	# GHTJKPV
渫	氵	枼	# GHTJKP
渭	氵	胃	# GHTJKPV
渰	氵	弇	# GHTKP
渲	氵	宣	# GHTJKP
渴	氵	曷	# GHTJKPV
游	氵	斿	# GHTJKP
渺	氵	眇	# GHTJKP
渼	氵	美	# GHTJKPV
湃	氵	拜	# GHTJKP
湄	氵	眉	# GHTJKPV
湉	氵	恬	# GHTJKP
湍	氵	耑	# GHTJKPV
湎	氵	面	# GHTJKPV
湑	氵	胥	# GHTJKP
湓	氵	盆	# GHTJKPV
湔	氵	前	# GHTKP
湜	氵	是	# GHTJKP
湝	氵	皆	# GHTJKP
湟	氵	皇	# GHTJKP
湣	氵	昬	# GHTJKP
湨	氵	狊	# GHTJKPV
湫	氵	秋	# GHTJKP
湮	氵	垔	# GHTK
湲	氵	爰	# GHTJKPV
湴	氵	並	# GHT
溁	氵	荣	# G
溃	氵	贵	# G
溅	氵	贱	# G
溆	氵	叙	# GHT
溇	氵	娄	# G
溉	氵	既	# GHT
溍	氵	晋	# G
溍	氵	晉	# HTJKP
溏	氵	唐	# GHTJKP
溘	氵	盍	# GHTJKPV
溚	氵	荅	# GHTKP
溞	氵	蚤	# GHTKP
溟	氵	冥	# GHTJKPV
溠	氵	差	# GHTJKP
溥	氵	尃	# GHTJKP
溦	氵	𢼸	# GP
溦	氵	𣁋	# HTK
溧	氵	栗	# GHTJKPV
溪	氵	奚	# GHTJKPV
溯	氵	朔	# GHTJKP
溱	氵	秦	# GHTJKP
溲	氵	叟	# GHTJK
溴	氵	臭	# GHTJKP
溵	氵	殷	# GHTKP
溷	氵	圂	# GHTJKPV
溹	氵	索	# GHTP
溻	氵	𦐇	# GHTJKP
溽	氵	辱	# HTJK
滁	氵	除	# GHTJKPV
滂	氵	旁	# GHTJKPV
滃	氵	翁	# GHTJKP
滆	氵	鬲	# GHTKP
滇	氵	真	# GHTV
滇	氵	眞	# JKP
滉	氵	晃	# GHTJKP
滍	氵	蚩	# GHTJKP
滏	氵	釜	# GHTJKP
滓	氵	宰	# GHTJKP
滔	氵	舀	# GHTJKPV
滕	月	𣳾	# GHTJKPV
滗	氵	笔	# GT
滚	氵	衮	# GHTP
滟	氵	艳	# G
滠	氵	聂	# G
满	氵	𬜯	# G
滢	氵	莹	# GH
滤	氵	虑	# G
滥	氵	监	# G
滦	氵	栾	# GT
滧	氵	效	# G
滨	氵	宾	# GHT
滩	氵	难	# GHT
滪	氵	预	# G
滫	氵	脩	# GHTJK
滹	氵	虖	# GHTJKP
漈	氵	祭	# GHTJKP
漋	氵	隆	# GHTK
漓	氵	离	# GHTJKPV
漖	氵	教	# GHT
漖	氵	敎	# J
漤	氵	婪	# GHTKP
漩	氵	旋	# GHTJKP
漪	氵	猗	# GHTJKP
漭	氵	莽	# GHT
漯	氵	累	# GHTJKP
漱	氵	欶	# GHTJKP
漳	氵	章	# GHTJKP
漴	氵	崇	# GHTKPV
漶	氵	患	# GHTJKP
漷	氵	郭	# GHTKP
漹	氵	焉	# GHTK
漻	氵	翏	# GHTJKP
漼	氵	崔	# GHTJKPV
漾	氵	羕	# GHTJKP
潆	氵	萦	# GT
潇	氵	萧	# G
潋	氵	敛	# G
潍	氵	维	# G
潏	氵	矞	# GHTJKP
潖	氵	琶	# GHTP
潘	氵	番	# GHTJKP
潞	氵	路	# GHTJKP
潢	氵	黄	# G
潢	氵	黃	# HTJKP
潦	氵	尞	# GHTJKPV
潩	氵	異	# GHTK
潭	氵	覃	# GHTKPV
潲	氵	稍	# GHTKP
潴	氵	猪	# GHTJKP
潵	氵	㪚	# V
潺	氵	孱	# GHTJKPV
潼	氵	童	# GHTJKP
潽	氵	普	# GHTJK
潾	氵	粦	# GHTJKP
澂	氵	𢽠	# GHTJKP
澈	氵	𰕎	# GHTJKP
澉	氵	敢	# GHTKP
澌	氵	斯	# GHTJKP
澍	氵	尌	# GHTJKP
澎	氵	彭	# GHTJKPV
澛	氵	鲁	# G
澜	氵	阑	# G
澡	氵	喿	# GHTJKP
澥	氵	解	# GHTJKP
澧	氵	豊	# GHTJKP
澪	氵	零	# GHTJK
澭	氵	雍	# GHTKP
澳	氵	奥	# GV
澳	氵	奧	# HTJKP
澴	氵	睘	# GHTKP
澶	氵	亶	# GHTJKP
澹	氵	詹	# GHTJKP
澼	氵	辟	# GHTJKP
澽	氵	豦	# GHTKP
濂	氵	廉	# GHTKPV
濉	氵	睢	# GHTJKP
濋	氵	楚	# GHTKP
濑	氵	赖	# G
濒	氵	频	# G
濞	氵	鼻	# GHTKPV
濩	氵	蒦	# GHJKP
濮	氵	僕	# GHTJKP
瀌	氵	麃	# GHTKP
瀍	氵	廛	# GHTJKP
瀑	氵	暴	# GHTJKP
瀔	氵	穀	# GHTK
瀚	氵	翰	# GHTJKP
瀛	氵	嬴	# GHTJKP
瀣	氵	韰	# GHTJKP
瀱	氵	罽	# GHTKP
瀵	氵	糞	# GHTKPV
瀹	氵	龠	# GHTJKP
瀼	氵	襄	# GHTJKP
灈	氵	瞿	# GHTJKP
灌	氵	雚	# GJKP[B]
灌	氵	雚	# HT
灏	澋	页	# G
灞	氵	霸	# GHTJKP
灶	火	土	# GHTJKPV
灿	火	山	# GHT
炀	火	𠃓	# G
炆	火	文	# GHTJKP
炌	火	介	# GTP
炒	火	少	# GHTJKPV
炔	火	夬	# GHTJKP
炕	火	亢	# GHTJKP
炖	火	屯	# GHTJKPV
炘	火	斤	# GHTJKP
炜	火	韦	# G
炝	火	仓	# G
炟	火	旦	# GHTJKPV
炣	火	可	# GHTP
炫	火	玄	# GHTJKP
炬	火	巨	# GHTJKP
炮	火	包	# GHTKPV
炯	火	冋	# GHTJKP
炳	火	丙	# GHTJKPV
炷	火	主	# GHTJKP
炸	火	乍	# GHTJKP
炻	火	石	# GHTJP
炼	火	𫠣	# GH
炽	火	只	# GH
烀	火	乎	# GHT
烁	火	乐	# G
烂	火	兰	# G
烃	火	𢀖	# G
烊	火	羊	# GHTJKPV
烔	火	同	# GHTJKP
烘	火	共	# GHTJKPV
烙	火	各	# GHTJKP
烛	火	虫	# GTPV
烜	火	亘	# GHTJKP
烟	火	因	# GHTJKP
烠	火	有	# GHTK
烤	火	考	# GHTJKV
烦	火	页	# G
烧	火	尧	# G
烨	火	华	# G
烩	火	会	# G
烬	火	尽	# GJ
烯	火	希	# GHTKP
烶	火	廷	# GHTKP
烷	火	完	# GHTK
烺	火	良	# GHTJKP
烻	火	延	# GHTKP
烽	火	夆	# GHTJKP
焆	火	肙	# GHTJKP
焊	火	旱	# GHTKP
焌	火	夋	# GHTJKP
焐	火	吾	# GHTK
焓	火	含	# GHTK
焕	火	奂	# G
焖	火	闷	# G
焗	火	局	# GHTK
焙	火	咅	# GHTJKPV
焜	火	昆	# GHTJKP
焞	火	享	# GHTJKPV
焯	火	卓	# GHTJKPV
焰	火	臽	# GHTJKP
煁	火	甚	# GHTJKP
煃	火	奎	# GHTKP
煅	火	段	# GHTJKP
煊	火	宣	# GHTJKP
煋	火	星	# GHTJKP
煌	火	皇	# GHTJKP
煓	火	耑	# GHTJKP
煜	火	昱	# GHTJKP
煟	火	胃	# GHTKP
煨	火	畏	# GHTJKPV
煳	火	胡	# GHK
煴	火	昷	# GHMTP
煸	火	扁	# GHTK
煺	火	退	# GHTV
熄	火	息	# GHTJKPV
熇	火	高	# GHTJKP
熘	火	留	# GHTK
熛	火	票	# GHTJKP
熜	火	悤	# GHKP
熠	火	習	# GHTJKP
熥	火	通	# GHTKP
熳	火	曼	# GHTJK
熵	火	商	# GHTK
熻	火	翕	# GMTKP
燋	火	焦	# GHTJKP
燎	火	尞	# GHTJKPV
燏	火	矞	# GHTKP
燔	火	番	# GHTJKP
燠	火	奥	# G
燠	火	奧	# HTJKP
燧	火	遂	# GHTKP
爔	火	羲	# GHTKP
爚	火	龠	# GHTJKP
爝	火	爵	# GHTK
爟	火	雚	# GHTKP
牁	爿	可	# GHTJKP
牂	爿	羊	# GHTJKP
牍	片	卖	# G
牤	牜	亡	# GTK
牥	牜	方	# GTKP
牦	牜	毛	# GHTKP
牯	牜	古	# GHTJKP
牺	牜	西	# GT
牻	牜	尨	# GHTJKP
牾	牜	吾	# GHTJKP
牿	牜	告	# GTKP
牿	牜	吿	# HJ
犄	牜	奇	# GHTJKP
犊	牜	卖	# G
犋	牜	具	# GHTK
犍	牜	建	# GHTJKP
犏	牜	扁	# GHTP
犒	牜	高	# GHTJKPV
犰	犭	九	# GHTJP
犴	犭	干	# GHTJKP
犷	犭	广	# G
犸	犭	马	# G
犹	犭	尤	# GTJKP
狁	犭	允	# GHTJKP
狃	犭	丑	# GHTJKPV
狄	犭	火	# GHTJKPV
狈	犭	贝	# G
狉	犭	丕	# GHTJKP
狍	犭	包	# GHTK
狎	犭	甲	# GHTJKP
狒	犭	弗	# GHTJKP
狝	犭	尔	# G
狝	犭	尓	# T
狞	犭	宁	# G
狠	犭	艮	# GHTJKP
狡	犭	交	# GHTJKPV
狨	犭	戎	# GHTKP
狮	犭	师	# G
狯	犭	会	# G
狰	犭	争	# G
狲	犭	孙	# G
狳	犭	余	# GHTJK
狴	犭	坒	# GHTJKP
狷	犭	肙	# GHTJKP
狺	犭	言	# GHTJKPV
狻	犭	夋	# GHTJKP
猁	犭	利	# GHTKP
猃	犭	佥	# G
猄	犭	京	# GHTJ
猇	犭	虎	# GHTJKP
猊	犭	兒	# GHTJKPV
猎	犭	昔	# GTKP
猓	犭	果	# GHTJKP
猕	犭	弥	# G
猖	犭	昌	# GHTJKP
猗	犭	奇	# GHTJKP
猜	犭	青	# GH[V][U]
猜	犭	青	# T
猜	犭	靑	# JKP
猝	犭	卒	# GHTJKPV
猞	犭	舍	# GHTJKP
猡	犭	罗	# G
猢	犭	胡	# GHTJKPV
猥	犭	畏	# GHTJKP
猩	犭	星	# GHTJKPV
猬	犭	胃	# GHTJKP
猯	犭	耑	# GTJKP
猰	犭	契	# GHTKP
猱	犭	柔	# GHTJKP
猴	犭	侯	# GHTJKPV
猸	犭	眉	# GHT
猹	犭	查	# GHJ
猹	犭	査	# K
猺	犭	䍃	# GHTJKP
猾	犭	骨	# GHTJKP
獍	犭	竟	# GHTJKP
獐	犭	章	# GHTJKP
獗	犭	厥	# GHTJKP
獠	犭	尞	# GHTJKP
獬	犭	解	# GHTJKPV
獭	犭	赖	# G
獯	犭	熏	# GHTJKP
獴	犭	蒙	# GHTP
獾	犭	雚	# GHTKP
玃	犭	矍	# GHTJKP
玎	𤣩	丁	# GHTJKP
玑	𤣩	几	# GT
玒	𤣩	工	# GHTKP
玓	𤣩	勺	# GHTK
玕	𤣩	干	# GHTJKP
玘	𤣩	己	# GHTJKP
玙	𤣩	与	# GM
玚	𤣩	𠃓	# G
玛	𤣩	马	# G
玞	𤣩	夫	# GHTJKP
玟	𤣩	文	# GHTJKP
玠	𤣩	介	# GHTJKP
玡	𤣩	牙	# GHTKPV
玢	𤣩	分	# GHTJKP
玤	𤣩	丰	# GT
玥	𤣩	月	# GHTJKP
玦	𤣩	夬	# GHTJKP
玭	𤣩	比	# GHTJKP
玮	𤣩	韦	# G
环	𤣩	不	# GTKP
现	𤣩	见	# G
玱	𤣩	仓	# G
玳	𤣩	代	# GHTJKPV
玶	𤣩	平	# GHTP
玷	𤣩	占	# GHTJKPV
玹	𤣩	玄	# GHTJKP
玻	𤣩	皮	# GHTJKPV
玼	𤣩	此	# GHTJKP
玿	𤣩	召	# GHTJKP
珀	𤣩	白	# GHTJKPV
珅	𤣩	申	# GHTJK
珇	𤣩	且	# GHTKP
珈	𤣩	加	# GHTJKP
珉	𤣩	民	# GHTJKP
珋	𤣩	卯	# GHTJK
珌	𤣩	必	# GHTJKP
珏	𤣩	玉	# GHTJKP
珐	𤣩	去	# GHT
珑	𤣩	龙	# G
珒	𤣩	聿	# GHTJK
珕	𤣩	劦	# GHTKP
珖	𤣩	光	# GHTJKP
珙	𤣩	共	# GHTJKP
珛	𤣩	有	# GHTKP
珝	𤣩	羽	# GHTJKP
珞	𤣩	各	# GHTJKP
珢	𤣩	艮	# GHTKP
珣	𤣩	旬	# GHTJKP
珥	𤣩	耳	# GHTJKPV
珦	𤣩	向	# GHTJKP
珧	𤣩	兆	# GHTJKP
珩	𤣩	行	# GHTJKPV
珫	𤣩	充	# GHTKP
珰	𤣩	当	# G
珲	𤣩	军	# G
珵	𤣩	呈	# GHTJKP
珷	𤣩	武	# GHTJKP
珸	𤣩	吾	# GHTJKP
珹	𤣩	成	# GHTJKP
珺	𤣩	君	# GHTJKP
珽	𤣩	廷	# GHTJKP
琀	𤣩	含	# GHTJKP
琄	𤣩	肙	# GHTJKP
琅	𤣩	良	# GHTJKP
琇	𤣩	秀	# GHTJKP
琈	𤣩	孚	# GHTKP
琊	𤣩	邪	# GHTJKP
琎	𤣩	进	# G
琏	𤣩	连	# G
琐	𤣩	𭕆	# G
琔	𤣩	定	# GHTKP
琚	𤣩	居	# GHTJKP
琛	𤣩	罙	# GHTJKP
琟	𤣩	隹	# GHTKP
琡	𤣩	叔	# GHTKP
琤	𤣩	争	# G
琤	𤣩	爭	# HTJKP
琥	𤣩	虎	# GHTJKPV
琦	𤣩	奇	# GHTJKP
琨	𤣩	昆	# GHTJKP
琪	𤣩	其	# GHTJKP
琫	𤣩	奉	# GHTJKP
琬	𤣩	宛	# GHTJKP
琭	𤣩	录	# G
琭	𤣩	彔	# HTJKP
琮	𤣩	宗	# GHTJKP
琯	𤣩	官	# GHTJKP
琰	𤣩	炎	# GHTJKPV
琲	𤣩	非	# GHTJKP
琼	𤣩	京	# GHT
瑀	𤣩	禹	# GHTJKP
瑁	𤣩	冒	# GHTKPV
瑂	𤣩	眉	# GHTKP
瑃	𤣩	春	# GHTJKP
瑄	𤣩	宣	# GHTJKP
瑅	𤣩	是	# GHTKP
瑆	𤣩	星	# GHTJKP
瑑	𤣩	彖	# GHTJKP
瑓	𤣩	柬	# GHTJ
瑔	𤣩	泉	# GHTKP
瑕	𤣩	叚	# GHTJKP
瑖	𤣩	段	# GHTKP
瑗	𤣩	爰	# GHTJKP
瑙	𤣩	𡿺	# GHTJKPV
瑜	𤣩	俞	# GHT
瑜	𤣩	兪	# JKP
瑝	𤣩	皇	# GHTJKP
瑢	𤣩	容	# GHTJKP
瑧	𤣩	秦	# GHTJK
瑨	𤣩	晉	# HTJKP
瑭	𤣩	唐	# GHTJKP
瑰	𤣩	鬼	# GHTJKP
瑱	𤣩	真	# GHT
瑱	𤣩	眞	# JKP
瑷	𤣩	爱	# G
瑾	𤣩	堇	# GHTJKP
璀	𤣩	崔	# GHTJKP
璁	𤣩	悤	# GHJKP
璆	𤣩	翏	# GHTJKP
璇	𤣩	旋	# GHTJKP
璈	𤣩	敖	# GHTJKP
璋	𤣩	章	# GHTJKP
璎	𤣩	婴	# G
璐	𤣩	路	# GHTJKP
璒	𤣩	登	# GHTJKP
璘	𤣩	粦	# GHTJKP
璜	𤣩	黄	# G
璜	𤣩	黃	# HTJKP
璞	𤣩	菐	# GHTJKP
璟	𤣩	景	# GHTJKP
璠	𤣩	番	# GHTJKP
璥	𤣩	敬	# GHTJKP
璨	𤣩	粲	# GHTJKP
璩	𤣩	豦	# GHTJKP
璪	𤣩	喿	# GHTJKP
璬	𤣩	敫	# GTP
璮	𤣩	亶	# GTJK
璱	𤣩	瑟	# GHTJKP
璲	𤣩	遂	# GHTKP
瓀	𤣩	需	# GHTKP
瓒	𤣩	赞	# G
瓖	𤣩	襄	# GHTJKP
瓘	𤣩	雚	# GHTJKP
瓠	夸	瓜	# GHTJKP
瓤	襄	瓜	# GHTJKP
瓯	区	瓦	# GTJKP
瓴	令	瓦	# GHTJKP
瓻	希	瓦	# GHTJKP
瓿	咅	瓦	# GHTJKP
甄	垔	瓦	# GHTK
甗	鬳	瓦	# GHTJKP
甡	生	生	# GHTJKP
畅	申	𠃓	# G
畈	田	反	# GHTJKP
畋	田	攵	# GHTJKP
畎	田	犬	# GHTJKP
畖	田	瓜	# GT
畛	田	㐱	# GHTJKP
畤	田	寺	# GHTJKP
畯	田	夋	# GHTJKP
畴	田	寿	# GJ
畸	田	奇	# GHTJKP
畹	田	宛	# GHTJKP
疁	田	翏	# GTJKP
疃	田	童	# GHTKP
疒	冫	广	# GHTJKP
癿	白	乚	# GHTKP
皈	白	反	# GHTJKP
皎	白	交	# GHTJKP
皑	白	岂	# G
皓	白	告	# GTJKP
皓	白	吿	# H
皕	百	百	# GHTJKP
皖	白	完	# GHTJKP
皞	白	皋	# GHTJKP
皤	白	番	# GHTJKP
皦	白	敫	# GHTJKP
皭	白	爵	# GHTK
皱	刍	皮	# G
皲	军	皮	# G
皴	夋	皮	# GHTJKP
盯	目	丁	# GHTKP
盱	目	于	# GHTJKP
盷	目	匀	# GP
盷	目	勻	# HTK
盹	目	屯	# GHTJKP
盼	目	分	# GHTJKP
眄	目	丏	# GHTJKP
眄	目	丐	# Z
眇	目	少	# GHTJKPV
眈	目	冘	# GHTJKPV
眊	目	毛	# GHTJKP
眍	目	区	# G
眙	目	台	# GHTJKP
眦	目	此	# GHTJKP
眨	目	乏	# GHTJKP
眩	目	玄	# GHTJKPV
眬	目	龙	# G
眭	目	圭	# GHTJKPV
眯	目	米	# GHTJKP
眵	目	多	# GHTJKP
眶	目	匡	# GHTJKP
眸	目	牟	# GHTJKP
睁	目	争	# GT
睃	目	夋	# GHTKP
睄	目	肖	# GHTKP
睇	目	弟	# GHTJKP
睎	目	希	# GHTJKP
睐	目	来	# G
睑	目	佥	# G
睚	目	厓	# GHTJKP
睛	目	青	# GH[V]
睛	目	青	# T
睛	目	靑	# JKP
睢	目	隹	# GHTJKP
睥	目	卑	# GHTKP
睨	目	兒	# GHTJKPV
睫	目	疌	# GHTJKP
睬	目	采	# GHTJKP
睹	目	者	# GHTKPV
睽	目	癸	# GHTJKPV
瞄	目	苗	# GHTJKP
瞅	目	秋	# GHTK
瞋	目	真	# GHTV
瞋	目	眞	# JKP
瞌	目	盍	# GHTJKP
瞍	目	叟	# GHTJKP
瞎	目	害	# GHTK
瞑	目	冥	# GHTJKPV
瞒	目	𬜯	# G
瞟	目	票	# GHTJKP
瞠	目	堂	# GHTJKP
瞧	目	焦	# GHTJKP
瞩	目	属	# GTJKP
瞪	目	登	# GHTJKPV
瞫	目	覃	# GHTKP
瞰	目	敢	# GHTJKP
瞵	目	粦	# GHTJKP
瞻	目	詹	# GHTJKPV
矜	矛	今	# GHTJKPV
矫	矢	乔	# G
矬	矢	坐	# GHTJKP
矮	矢	委	# GHTJKPV
矰	矢	曾	# GHTJKP
矶	石	几	# GT
矸	石	干	# GHTJKP
矻	石	乞	# GHTJKP
矼	石	工	# GHTJKP
矽	石	夕	# GHTK
矾	石	凡	# GHT
矿	石	广	# G
砀	石	𠃓	# G
码	石	马	# G
砄	石	夬	# GT
砆	石	夫	# GHTJKP
砌	石	切	# GHTJKP
砍	石	欠	# GHTJKP
砑	石	牙	# GHTJKP
砒	石	比	# GHTJKP
砖	石	专	# G
砗	石	车	# G
砘	石	屯	# GHTKP
砚	石	见	# G
砜	石	风	# GH
砝	石	去	# GHTJKP
砟	石	乍	# GHTKP
砠	石	且	# GHTJKP
砣	石	它	# GHTJKP
砩	石	弗	# GHTKP
砫	石	主	# GHTKP
砬	石	立	# GHTJKP
砭	石	乏	# GHTJKPV
砰	石	平	# GHTJKP
砵	石	本	# GHTJK
砷	石	申	# GHTJK
砸	石	匝	# GHT
砹	石	艾	# GH
砼	石	仝	# GHK
砾	石	乐	# G
础	石	出	# G
硁	石	𢀖	# G
硁	石	𱑱	# P
硅	石	圭	# GHTJKP
硇	石	囟	# GHTJKP
硊	石	危	# GHTKP
硌	石	各	# GHTJKPV
硍	石	艮	# GHTKP
硎	石	刑	# GHTJKP
硐	石	同	# GHTKP
硒	石	西	# GHTJK
硔	石	共	# GHT
硕	石	页	# G
硖	石	夹	# G
硗	石	尧	# G
硙	石	岂	# G
硚	石	乔	# G
硪	石	我	# GHTJKP
硭	石	芒	# GHTKP
确	石	角	# GHTJKP
硷	石	佥	# G
硼	石	朋	# GHTJKP
硿	石	空	# GHTKP
碃	石	青	# GHT
碃	石	靑	# K
碈	石	昏	# GHT
碉	石	周	# GHTKP
碌	石	录	# G
碌	石	彔	# HTJKP
碎	石	卒	# GHTJKPV
碏	石	昔	# GHTJKP
碘	石	典	# GHTJK
碚	石	咅	# GHTJKP
碛	石	责	# G
碜	石	参	# GT
碟	石	枼	# GHTJKP
碡	石	毒	# GHTJKP
碣	石	曷	# GHTJKP
碥	石	扁	# GHTKP
碨	石	畏	# GHTJKP
碰	石	並	# GHT
碱	石	咸	# GHTJK
碲	石	帝	# GHTJK
碳	石	炭	# GHTJK
碴	石	查	# GHT
碶	石	契	# GHKP
碹	石	宣	# GHTK
碾	石	展	# GHTJKP
磅	石	旁	# GHTJKP
磉	石	桑	# GHTJKPV
磋	石	差	# GHTJKPV
磏	石	兼	# GHTKP
磔	石	桀	# GHTJKPV
磕	石	盍	# GHTJKP
磜	石	祭	# GTP
磡	石	勘	# GHTJKP
磲	石	渠	# GHTJKP
磴	石	登	# GHTJKP
磷	石	粦	# GHTJKPV
磹	石	覃	# GHTKP
磺	石	黄	# GV
磺	石	黃	# HTJKP
磻	石	番	# GHTJKP
礅	石	敦	# GHT
礌	石	雷	# GHTJKPV
礓	石	畺	# GHTKP
礞	石	蒙	# GHTJK
礞	石	𫎇	# P
礤	石	蔡	# GHTKP
礳	石	磨	# GH
礴	石	薄	# GHTJKP
礵	石	霜	# GHTJK
祀	礻	巳	# GHT
祀	示	巳	# JKP
祃	礻	马	# G
祆	礻	天	# GHT
祆	示	天	# JKP
祊	礻	方	# GHT
祊	示	方	# JKP
祋	礻	殳	# GHT
祋	示	殳	# JKP
祎	礻	韦	# G
祏	礻	石	# GHT
祏	示	石	# JKP
祓	礻	犮	# GHT
祓	示	犮	# JK
祕	礻	必	# GHT
祕	示	必	# JKP
祗	礻	氐	# GHT
祗	示	氐	# JKP
祚	礻	乍	# GHTV
祚	示	乍	# JKP
祛	礻	去	# GHT
祛	示	去	# JKP
祜	礻	古	# GHT
祜	示	古	# JKP
祠	礻	司	# GHTV
祠	示	司	# JKP
祧	礻	兆	# GHT
祧	示	兆	# JKP
祯	礻	贞	# G
祲	礻	𠬶	# GHT
祲	示	𠬶	# JKP
祸	礻	呙	# G
祺	礻	其	# GHT
祺	示	其	# JKP
祼	礻	果	# GHT
祼	示	果	# JKP
祾	礻	夌	# GHT
祾	示	夌	# JKP
禊	礻	契	# GHT
禊	示	契	# JKP
禋	礻	垔	# GHT
禋	示	垔	# JK
禒	礻	彖	# GHT
禒	示	彖	# KP
禔	礻	是	# GHT
禔	示	是	# JKP
禘	礻	帝	# GHT
禘	示	帝	# JKP
禚	礻	羔	# GHT
禚	示	羔	# KP
禛	礻	真	# GHT
禛	示	眞	# JKP
禧	礻	喜	# GHT
禧	示	喜	# JK
禳	礻	襄	# GHT
禳	示	襄	# JKP
秆	禾	干	# GHTKP
种	禾	中	# GHTJKP
秕	禾	比	# GHTJKP
秣	禾	末	# GHTJKP
秧	禾	央	# GHTJKPV
秫	禾	术	# G
秫	禾	朮	# HTJKP
秬	禾	巨	# GHTJKP
秭	禾	𠂔	# GHTJKP
积	禾	只	# G
秸	禾	吉	# GHTJKPV
秽	禾	岁	# GK
秾	禾	农	# G
稂	禾	良	# GHTJKP
稃	禾	孚	# GHTJKP
稆	禾	吕	# G
稆	禾	呂	# HTP
稌	禾	余	# GHTJKP
稍	禾	肖	# GHTJKPV
稑	禾	坴	# GHTJKP
稙	禾	直	# GHTJKP
稞	禾	果	# GHTJKP
稠	禾	周	# GHTKP
稣	鱼	禾	# G
稳	禾	急	# GT
稷	禾	畟	# GHTJKPV
稹	禾	真	# GHT
稹	禾	眞	# JKP
稻	禾	舀	# GHTJKP
穄	禾	祭	# GHTJKP
穑	禾	啬	# G
穗	禾	惠	# GHTJKP
穙	禾	菐	# GTJKP
穜	禾	童	# GHTJKP
穟	禾	遂	# GHTKP
穰	禾	襄	# GHTJKP
竑	立	厷	# GHTJKP
竘	立	句	# GHTKP
站	立	占	# GHTJKPV
竦	立	束	# GHTJKP
竫	立	争	# G
竫	立	爭	# HTJKP
竭	立	曷	# GHTJKPV
籼	米	山	# GHTJKP
籽	米	子	# GHTJKP
粑	米	巴	# GHTKV
粝	米	厉	# GTP
粞	米	西	# GHTJKP
粮	米	良	# GHTJKPV
粳	米	更	# GHTJKP
粹	米	卒	# GHTJKPV
粼	粦	巜	# GHTJKP
粽	米	宗	# GHTJKP
粿	米	果	# GHTJKP
糁	米	参	# GT
糅	米	柔	# GHTJKP
糇	米	侯	# GHTJKP
糈	米	胥	# GHTJKP
糌	米	昝	# GHTK
糍	米	兹	# GTJKP
糍	米	茲	# H
糒	米	𤰇	# GHTJKP
糕	米	羔	# GHTJKP
糗	米	臭	# GHTJKP
糙	米	造	# GHTJKP
糨	米	强	# GKP
糨	米	強	# HT
糯	米	需	# GHTJKP
縢	月	絭	# GHTJKP
繇	䍃	系	# GHTJKP
纠	纟	丩	# G
纡	纟	于	# G
红	纟	工	# G
纣	纟	寸	# G
纤	纟	千	# GH
纥	纟	乞	# G
约	纟	勺	# G
级	纟	及	# G
纨	纟	？	# G
纩	纟	广	# G
纪	纟	己	# G
纫	纟	刃	# G
纬	纟	韦	# GH
纭	纟	云	# G
纮	纟	厷	# G
纯	纟	屯	# G
纰	纟	比	# G
纱	纟	少	# G
纲	纟	冈	# G
纳	纟	内	# G
纴	纟	壬	# G
纵	纟	从	# G
纶	纟	仑	# G
纷	纟	分	# G
纸	纟	氏	# G
纹	纟	文	# G
纺	纟	方	# GH
纻	纟	㝉	# G
纼	纟	引	# G
纽	纟	丑	# G
纾	纟	予	# G
线	纟	戋	# G
绀	纟	甘	# G
绁	纟	世	# G
绂	纟	犮	# G
练	纟	𫠣	# G
组	纟	且	# G
绅	纟	申	# G
细	纟	田	# G
织	纟	只	# GH
终	纟	冬	# G
绉	纟	刍	# G
绊	纟	半	# G
绋	纟	弗	# G
绌	纟	出	# G
绍	纟	召	# G
绎	纟	𠬤	# G
经	纟	𢀖	# GH
绐	纟	台	# G
绑	纟	邦	# G
绒	纟	戎	# G
结	纟	吉	# G
绔	纟	夸	# G
绕	纟	尧	# G
绖	纟	至	# G
绗	纟	行	# G
绘	纟	会	# G
给	纟	合	# G
绚	纟	旬	# G
绛	纟	夅	# G
络	纟	各	# G
绝	纟	色	# G
绞	纟	交	# G
统	纟	充	# GH
绠	纟	更	# G
绡	纟	肖	# G
绢	纟	肙	# G
绣	纟	秀	# G
绤	纟	谷	# G
绥	纟	妥	# G
绦	纟	条	# G
绨	纟	弟	# G
绩	纟	责	# G
绪	纟	者	# G
绫	纟	夌	# G
续	纟	卖	# G
绮	纟	奇	# G
绯	纟	非	# G
绰	纟	卓	# G
绱	纟	尚	# G
绲	纟	昆	# G
绳	纟	黾	# G
维	纟	隹	# G
绵	纟	帛	# G
绶	纟	受	# G
绷	纟	朋	# G
绸	纟	周	# G
绹	纟	匋	# G
绺	纟	咎	# G
绻	纟	卷	# G
综	纟	宗	# G
绽	纟	定	# G
绾	纟	官	# G
绿	纟	录	# G
缀	纟	叕	# G
缁	纟	甾	# G
缂	纟	革	# G
缃	纟	相	# G
缄	纟	咸	# G
缅	纟	面	# G
缆	纟	览	# GH
缇	纟	是	# G
缈	纟	眇	# G
缉	纟	咠	# G
缊	纟	昷	# G
缋	纟	贵	# G
缌	纟	思	# G
缍	纟	垂	# G
缎	纟	段	# G
缏	纟	便	# G
缐	纟	泉	# GM
缑	纟	侯	# G
缒	纟	追	# G
缓	纟	爰	# G
缔	纟	帝	# G
缕	纟	娄	# G
编	纟	扁	# G
缗	纟	昬	# G
缘	纟	彖	# G
缙	纟	晋	# G
缚	纟	尃	# G
缛	纟	辱	# Z
缜	纟	真	# G
缝	纟	逢	# G
缞	纟	衰	# G
缟	纟	高	# G
缠	纟	㢆	# G
缡	纟	离	# G
缢	纟	益	# G
缣	纟	兼	# G
缤	纟	宾	# G
缥	纟	票	# G
缦	纟	曼	# G
缧	纟	累	# G
缨	纟	婴	# G
缩	纟	宿	# G
缪	纟	翏	# G
缫	纟	巢	# G
缬	纟	颉	# G
缭	纟	尞	# G
缮	纟	善	# G
缯	纟	曾	# G
缰	纟	畺	# G
缱	纟	遣	# G
缲	纟	喿	# G
缳	纟	睘	# G
缴	纟	敫	# G
缵	纟	赞	# G
缸	缶	工	# GHTJKPV
缺	缶	夬	# GHTJKPV
罅	缶	虖	# GHTJKP
罐	缶	雚	# GHTJK
羓	羊	巴	# GHTKP
羖	羊	殳	# GHTJKP
羚	羊	令	# GHTJKP
羝	羊	氐	# GHTJKPV
羟	羊	𢀖	# G
羧	羊	夋	# GHTKP
羯	羊	曷	# GHTJKP
羰	羊	炭	# GHTK
羱	羊	原	# GHTKP
翀	羽	中	# GHTJKP
翂	羽	分	# GHTKP
翃	厷	羽	# GHTJKP
翈	甲	羽	# GTJP
翊	立	羽	# GHTJKP
翎	令	羽	# GHTJKPV
翔	羊	羽	# GHTKP
翙	岁	羽	# GM
翩	扁	羽	# GHTJKPV
翮	鬲	羽	# GHTJKP
翱	皋	羽	# GHMTP
翷	粦	羽	# GHTKP
翾	睘	羽	# GHTJKP
耏	而	彡	# GHTJKP
耔	耒	子	# GHTJKP
耖	耒	少	# GHTJKP
耘	耒	云	# GHTJKP
耙	耒	巴	# GHTJKPV
耜	耒	㠯	# GHJKP
耠	耒	合	# GHTJK
耢	耒	劳	# G
耤	耒	昔	# GHTJKP
耥	耒	尚	# GHT
耦	耒	禺	# GHTJKP
耧	耒	娄	# G
耨	耒	辱	# HTV
耩	耒	冓	# GHTKP
耪	耒	旁	# GHT
耰	耒	憂	# GHTJKP
耱	耒	磨	# GHT
耲	耒	褱	# GT
耵	耳	丁	# GHTJKP
耻	耳	止	# GHTJKP
耿	耳	火	# GHTJKP
聃	耳	冉	# GHTKP
聆	耳	令	# GHTJKP
聊	耳	卯	# GHTJKP
职	耳	只	# G
聍	耳	宁	# G
聒	耳	舌	# GHTJKP
联	耳	关	# GH
聘	耳	甹	# GHTJKPV
聩	耳	贵	# G
聪	耳	总	# GT
肄	𠤕	聿	# GHTJKP
肆	镸	聿	# GHTJKP
肚	月	土	# GJKP
肚	⺼	土	# HT
肛	月	工	# GJKPV
肛	⺼	工	# HT
肜	月	彡	# GJKP
肜	⺼	彡	# HT
肟	月	亏	# G
肟	⺼	亏	# HT
肠	月	𠃓	# G
肤	月	夫	# GJ
肤	⺼	夫	# T
肫	月	屯	# GJKP[B]
肫	⺼	屯	# HT
肭	⺼	內	# HT
肭	月	內	# JKP
肮	月	亢	# GKP
肮	⺼	亢	# HT
肷	月	欠	# GP
肷	⺼	欠	# HT
肸	月	𰅭	# GJKP
肸	⺼	𰅭	# HT
肼	月	井	# GH
肼	⺼	井	# T
肽	月	太	# GH
肿	月	中	# G
胀	月	长	# G
胁	月	办	# G
胂	月	申	# GKPV
胂	⺼	申	# HT
胈	月	犮	# GJK
胈	⺼	犮	# HT
胍	月	瓜	# GJKP
胍	⺼	瓜	# HT
胖	月	半	# GKPV
胖	⺼	半	# HT
胗	月	㐱	# GJKPV
胗	⺼	㐱	# HT
胙	月	乍	# GJKP
胙	⺼	乍	# HT
胚	月	丕	# GJKP
胚	⺼	丕	# HT
胛	月	甲	# GJKP
胛	⺼	甲	# HT
胜	月	生	# GKPV
胜	⺼	生	# HT
胝	月	氐	# GJKPV
胝	⺼	氐	# HT
胠	月	去	# GJKP
胠	⺼	去	# HT
胣	月	㐌	# GKPV
胣	⺼	㐌	# HT
胧	月	龙	# G
胨	月	东	# G
胩	月	卡	# G
胩	⺼	卡	# HT
胪	月	卢	# G
胫	月	𢀖	# G
胭	月	因	# GJKPV
胭	⺼	因	# HT
胯	月	夸	# GJKP
胯	⺼	夸	# HT
胰	月	夷	# GJKP
胰	⺼	夷	# HT
胱	月	光	# GJKPV
胱	⺼	光	# HT
胲	月	亥	# GJKP
胲	⺼	亥	# HT
胳	月	各	# GJKPV
胳	⺼	各	# HT
胶	⺼	交	# HT
胺	月	安	# GJKPV
胺	⺼	安	# HT
胼	⺼	并	# HT
脉	月	永	# GJKPV[B]
脉	⺼	永	# HT
脍	月	会	# GJ
脎	月	杀	# G
脎	⺼	𣏂	# H
脏	月	庄	# G
脐	月	齐	# G
脑	月	㐫	# G
脒	月	米	# G
脒	⺼	米	# H
脓	月	农	# G
脖	月	孛	# GJKP
脖	⺼	孛	# HT
脘	月	完	# GJKP
脘	⺼	完	# HT
脞	月	坐	# GJKP
脞	⺼	坐	# HT
脟	月	寽	# GK
脟	⺼	寽	# HT
脬	月	孚	# GJKP
脬	⺼	孚	# HT
脯	月	甫	# GJKP
脯	⺼	甫	# HT
脲	月	尿	# G
脲	⺼	尿	# HT
脶	月	呙	# G
脸	月	佥	# G
脾	月	卑	# GKP
脾	⺼	卑	# HT
脿	月	表	# GPV
脿	⺼	表	# T
腆	月	典	# GJKP
腆	⺼	典	# HT
腈	月	青	# GP
腈	⺼	青	# HT
腈	月	靑	# K
腊	月	昔	# GJKPV
腊	⺼	昔	# HT
腋	月	夜	# GJKPV
腋	⺼	夜	# HT
腌	月	奄	# GJKP
腌	⺼	奄	# HT
腑	月	府	# GJKPV
腑	⺼	府	# HT
腒	月	居	# GJKP
腒	⺼	居	# HT
腓	月	非	# GJKP
腓	⺼	非	# HT
腕	月	宛	# GJKPV
腕	⺼	宛	# HT
腘	月	国	# G
腘	⺼	国	# T
腙	月	宗	# G
腙	⺼	宗	# HT
腚	月	定	# G
腚	⺼	定	# H
腠	月	奏	# GJKP
腠	⺼	奏	# HT
腥	月	星	# GJKPV
腥	⺼	星	# HT
腧	月	俞	# G
腧	⺼	俞	# HT
腧	月	兪	# JK
腨	月	耑	# GJKP
腨	⺼	耑	# T
腩	月	南	# GJKPV
腩	⺼	南	# HT
腭	月	咢	# GJKP
腭	⺼	咢	# HT
腮	月	思	# GJKPV
腮	⺼	思	# HT
腯	月	盾	# GJKP
腯	⺼	盾	# HT
腱	月	建	# GJKP
腱	⺼	建	# HT
腴	月	臾	# GJKP
腴	⺼	臾	# HT
腻	月	贰	# G
腼	月	面	# G
腼	⺼	面	# H
腽	月	昷	# G
腽	⺼	昷	# HMT
腾	月	𱅑	# G
膀	月	旁	# GJKPV
膀	⺼	旁	# HT
膈	月	鬲	# GJKPV
膈	⺼	鬲	# HT
膊	月	尃	# GJKP
膊	⺼	尃	# HT
膑	月	宾	# G
膘	月	票	# GJKP
膘	⺼	票	# HT
膙	月	强	# GKPV
膙	⺼	強	# HT
膛	月	堂	# GJKP
膛	⺼	堂	# HT
膣	月	窒	# GJKP
膣	⺼	窒	# HT
膦	月	粦	# GKP
膦	⺼	粦	# HT
膪	月	啻	# G
膪	⺼	啻	# HT
膻	月	亶	# GJKP
膻	⺼	亶	# HT
臁	月	廉	# GPV
臁	⺼	廉	# HT
臁	⺼	亷	# U
臃	月	雍	# GJKPV
臃	⺼	雍	# HT
臊	月	喿	# GJKP
臊	⺼	喿	# HT
臌	月	鼓	# GK
臌	⺼	鼓	# HT
臑	月	需	# GJKP
臑	⺼	需	# HT
臜	月	赞	# G
臻	至	秦	# GHTJKP
舐	舌	氏	# GHTJKP
舒	舍	予	# GHTJKPV
舔	舌	忝	# GHTJKP
舠	舟	刀	# GHTKP
舡	舟	工	# GHTJKP
舢	舟	山	# GHTJKP
舣	舟	义	# G
舥	舟	巴	# GHTKPV
舨	舟	反	# GHTJK
舫	舟	方	# GHTJKP
舭	舟	比	# GHTP
舯	舟	中	# GHT
舰	舟	见	# G
舱	舟	仓	# G
舲	舟	令	# GHTJKP
舳	舟	由	# GHTJKP
舴	舟	乍	# GHTJKP
舸	舟	可	# GHTJKP
舻	舟	卢	# G
舾	舟	西	# GH
艄	舟	肖	# GHTJKP
艅	舟	余	# GHTJKP
艉	舟	尾	# GHTJK
艋	舟	孟	# GHTJKPV
艎	舟	皇	# GHTJKP
艏	舟	首	# GHTJKP
艘	舟	叟	# GHTJK
艚	舟	曹	# GHTJKPV
艟	舟	童	# GHTJKPV
艨	舟	蒙	# GHTJKP
艰	又	艮	# G
艳	丰	色	# GT
艴	弗	色	# GHTJKP
艹	十	十	# HTK
荆	茾	刂	# G
蒯	萠	刂	# GHTJKP
虓	九	虎	# GHTJKP
虢	寽	虎	# GHTJK
虤	虎	虎	# GHTJKP
虬	虫	乚	# GHTJKPV
虮	虫	几	# GHTKV
虷	虫	干	# GHTJKP
虸	虫	子	# GTKPV
虼	虫	乞	# GHTK
虾	虫	下	# GHTK
蚀	饣	虫	# G
蚁	虫	义	# G
蚂	虫	马	# G
蚄	虫	方	# GTKP
蚆	虫	巴	# GHTKP
蚋	虫	内	# G
蚋	虫	內	# HTJKP
蚌	虫	丰	# GHTJ
蚍	虫	比	# GHTJKP
蚓	虫	引	# GHTJKPV
蚜	虫	牙	# GHTJKV
蚝	虫	毛	# GHTJKP
蚣	虫	公	# GHTJKP
蚧	虫	介	# GHTJKPV
蚨	虫	夫	# GHTJKPV
蚪	虫	斗	# GHTJKP
蚬	虫	见	# G
蚯	虫	丘	# GHTJKP
蚰	虫	由	# GHTJKP
蚱	虫	乍	# GHTJKP
蚲	虫	平	# GHTP
蚴	虫	幼	# GHTJKP
蚵	虫	可	# GHTJKPV
蚶	虫	甘	# GHTJKP
蚺	虫	冉	# GHTK
蛀	虫	主	# GHTJKPV
蛃	虫	丙	# GHTJKP
蛄	虫	古	# GHTJKPV
蛆	虫	且	# GHTJKP
蛉	虫	令	# GHTJKP
蛏	虫	圣	# GT
蛐	虫	曲	# GHTKP
蛑	虫	牟	# GHTJKP
蛔	虫	回	# GHTJKP
蛘	虫	羊	# GHTKP
蛛	虫	朱	# GHTJKPV
蛞	虫	舌	# GHTJKP
蛟	虫	交	# GHTJKPV
蛱	虫	夹	# G
蛲	虫	尧	# G
蛳	虫	师	# G
蛴	虫	齐	# G
蛹	虫	甬	# GHTJKPV
蜈	虫	吴	# G
蜈	虫	吳	# HTJKP
蜉	虫	孚	# GHTJKP
蜊	虫	利	# GHTJKP
蜍	虫	余	# GHTJKPV
蜎	虫	肙	# GHTJKP
蜐	虫	劫	# GTJP
蜒	虫	延	# GHTJKP
蜓	虫	廷	# GHTJKP
蜗	虫	呙	# G
蜞	虫	其	# GHTJKP
蜡	虫	昔	# GHTJKP
蜢	虫	孟	# GHTKP
蜣	虫	羌	# GHTJKP
蜥	虫	析	# GHTJKP
蜩	虫	周	# GHTKP
蜮	虫	或	# GHTJKP
蜱	虫	卑	# GHTKP
蜴	虫	易	# GHTJKP
蜷	虫	卷	# GHTJKP
蜻	虫	青	# GHT
蜻	虫	靑	# JKP
蜾	虫	果	# GHTJKP
蜿	虫	宛	# GHTJKP
蝇	虫	黾	# GKP
蝈	虫	国	# G
蝌	虫	科	# GHTJKP
蝎	虫	曷	# GHTJKPV
蝓	虫	俞	# GHT
蝓	虫	兪	# JK
蝗	虫	皇	# GHTJKP
蝘	虫	匽	# GHTJKP
蝙	虫	扁	# GHTJKP
蝠	虫	畐	# GHTJKP
蝣	虫	斿	# GHTJKPV
蝤	虫	酋	# GHTJKP
蝮	虫	复	# GHTJKP
蝰	虫	奎	# GHTKP
蝲	虫	剌	# GTJKP
蝴	虫	胡	# GHTJKPV
蝻	虫	南	# GHTJKP
蝼	虫	娄	# GTJP
蝽	虫	春	# GHT
蝾	虫	荣	# G
螂	虫	郎	# GHTP
螂	虫	郞	# JK
螃	虫	旁	# GHTJKP
螅	虫	息	# GHTJKP
螈	虫	原	# GHTJKP
螋	虫	叟	# GHTJKP
螓	虫	秦	# GHTJKPV
螗	虫	唐	# GHTJKP
螟	虫	冥	# GHTJKP
螠	虫	益	# GTJKPV
螣	月	䖭	# GHTJKP
螨	虫	𬜯	# G
螬	虫	曹	# GHTJKP
螭	虫	离	# GHTJKP
螳	虫	堂	# GHTJKP
螵	虫	票	# GHTJKP
蟀	虫	率	# GHT
蟆	虫	莫	# GHTJKP
蟋	虫	悉	# GHTJKP
蟏	虫	萧	# G
蟑	虫	章	# GHTK
蟒	虫	莽	# GHTJPV
蟓	虫	象	# GHTKP
蟛	虫	彭	# GHTKP
蟠	虫	番	# GHTJKP
蟥	虫	黄	# G
蟥	虫	黃	# HTJKP
蟪	虫	惠	# GHTJKP
蟫	虫	覃	# GHTJKP
蟮	虫	善	# GHTKP
蟾	虫	詹	# GHTJKP
蠊	虫	廉	# GHTKP
蠋	虫	蜀	# GHTJKP
蠓	虫	蒙	# GHTJKPV
蠕	虫	需	# GHTJKP
蠖	虫	蒦	# GHJKP
蠛	虫	蔑	# GHTJKPV
蠲	益	蜀	# GHTJKP
蠼	虫	矍	# GHTJKP
衃	血	不	# GHTJKP
衄	血	丑	# GHTJKPV
衅	血	半	# GHTKPV
衍	彳	𣲇	# X
补	衤	卜	# GH
衩	衤	叉	# GHTJKP
衫	衤	彡	# GHTJKPV
衬	衤	寸	# G
衲	衤	内	# GV
衲	衤	內	# HTJKP
衽	衤	壬	# GHTJKPV
袂	衤	夬	# GHTJKP
袄	衤	夭	# GHTPV
袆	衤	韦	# G
袍	衤	包	# GHTKPV
袒	衤	旦	# GHTJKP
袗	衤	㐱	# GHTJKP
袜	衤	末	# GHTJKP
袢	衤	半	# GHTKP
袪	衤	去	# GHTJKPV
袯	衤	发	# G
袱	衤	伏	# GHTJKP
袼	衤	各	# GHTJKP
裆	衤	当	# G
裈	衤	军	# G
裉	衤	艮	# GHT
裎	衤	呈	# GHTJKP
裙	衤	君	# GHTJKPV
裢	衤	连	# G
裣	衤	佥	# G
裤	衤	库	# G
裥	衤	间	# G
裨	衤	卑	# GHTKP
裰	衤	叕	# GHTJKP
裱	衤	表	# GHTJKPV
裼	衤	易	# GHTJKP
褂	衤	卦	# GHTJKP
褊	衤	扁	# GHTJKP
褓	衤	保	# GHTJKPV
褕	衤	俞	# GHT
褕	衤	兪	# JK
褙	衤	背	# GHTJKP
褚	衤	者	# GHTKP
褛	衤	娄	# GTP
褟	衤	𦐇	# GHTK
褡	衤	荅	# GHTKP
褥	衤	辱	# HT
褪	衤	退	# GHTJKP
褫	衤	虒	# GHTJKP
褯	衤	席	# GHTKP
褴	衤	监	# G
褶	衤	習	# GHTJKPV
襁	衤	强	# GKP
襁	衤	強	# HTJ
襕	衤	阑	# G
襚	衤	遂	# GHTKP
襜	衤	詹	# GHTJKPV
襦	衤	需	# GHTJKP
襫	衤	奭	# GHTJKP
襻	衤	攀	# GHTJKP
观	又	见	# G
规	夫	见	# G
视	礻	见	# GH
觇	占	见	# G
觊	岂	见	# G
觋	巫	见	# G
觌	卖	见	# G
觎	俞	见	# G
觏	冓	见	# G
觐	堇	见	# G
觑	虚	见	# G
觖	角	夬	# GHTJKP
觚	角	瓜	# GHTJKPV
觟	角	圭	# GHTKPV
觥	角	光	# GHTJKPV
觫	角	束	# GHTJKPV
觭	角	奇	# GHTJKP
觯	角	单	# G
觿	角	巂	# GHTJKP
计	讠	十	# G
订	讠	丁	# G
讣	讠	卜	# G
认	讠	人	# G
讥	讠	几	# G
讦	讠	干	# G
讧	讠	工	# G
讨	讠	寸	# G
让	讠	上	# G
讪	讠	山	# G
讫	讠	乞	# G
训	讠	川	# G
议	讠	义	# G
讯	讠	卂	# G
记	讠	己	# G
讱	讠	刃	# G
讲	讠	井	# G
讳	讠	韦	# G
讴	讠	区	# G
讵	讠	巨	# G
讶	讠	牙	# G
讷	讠	内	# G
许	讠	午	# G
讹	讠	化	# G
论	讠	仑	# G
讻	讠	凶	# G
讼	讠	公	# G
讽	讠	风	# G
设	讠	殳	# GH
访	讠	方	# G
诀	讠	夬	# G
证	讠	正	# G
诂	讠	古	# G
诃	讠	可	# G
评	讠	平	# G
诅	讠	且	# G
识	讠	只	# G
诇	讠	冋	# G
诈	讠	乍	# G
诉	讠	斥	# G
诊	讠	㐱	# G
诋	讠	氐	# G
诌	讠	刍	# G
词	讠	司	# G
诎	讠	出	# G
诏	讠	召	# G
诐	讠	皮	# G
译	讠	𠬤	# G
诒	讠	台	# G
诓	讠	匡	# G
诔	讠	耒	# G
试	讠	式	# G
诖	讠	圭	# G
诗	讠	寺	# G
诘	讠	吉	# G
诙	讠	灰	# G
诚	讠	成	# G
诛	讠	朱	# G
诜	讠	先	# G
话	讠	舌	# G
诞	讠	延	# G
诟	讠	后	# G
诠	讠	全	# G
诡	讠	危	# G
询	讠	旬	# GH
诣	讠	旨	# G
诤	讠	争	# G
该	讠	亥	# G
详	讠	羊	# G
诧	讠	宅	# G
诨	讠	军	# G
诩	讠	羽	# G
诫	讠	戒	# G
诬	讠	巫	# G
语	讠	吾	# G
诮	讠	肖	# G
误	讠	吴	# G
诰	讠	告	# G
诱	讠	秀	# G
诲	讠	每	# G
诳	讠	狂	# G
说	讠	兑	# G
诵	讠	甬	# G
诶	讠	矣	# G
请	讠	青	# G
诸	讠	者	# G
诹	讠	取	# G
诺	讠	若	# G
读	讠	卖	# G
诼	讠	豖	# G
诽	讠	非	# G
课	讠	果	# G
诿	讠	委	# G
谀	讠	臾	# G
谁	讠	隹	# G
谂	讠	念	# G
调	讠	周	# G
谄	讠	臽	# G
谅	讠	京	# G
谆	讠	享	# G
谇	讠	卒	# G
谈	讠	炎	# G
谊	讠	宜	# G
谋	讠	某	# G
谌	讠	甚	# G
谍	讠	枼	# G
谎	讠	荒	# G
谏	讠	柬	# G
谐	讠	皆	# G
谑	讠	虐	# G
谒	讠	曷	# G
谓	讠	胃	# G
谔	讠	咢	# G
谕	讠	俞	# G
谖	讠	爰	# G
谗	讠	𫥎	# G
谘	讠	咨	# G
谙	讠	音	# G
谚	讠	彦	# G
谛	讠	帝	# G
谜	讠	迷	# G
谝	讠	扁	# G
谞	讠	胥	# G
谟	讠	莫	# G
谠	讠	党	# G
谡	讠	畟	# G
谢	讠	射	# G
谣	讠	䍃	# G
谤	讠	旁	# G
谥	讠	益	# G
谦	讠	兼	# G
谧	讠	𥁑	# G
谨	讠	堇	# G
谩	讠	曼	# G
谪	讠	啇	# G
谫	讠	剪	# G
谬	讠	翏	# G
谭	讠	覃	# G
谮	讠	朁	# G
谯	讠	焦	# G
谰	讠	阑	# G
谱	讠	普	# G
谲	讠	矞	# G
谳	讠	献	# G
谴	讠	遣	# G
谵	讠	詹	# G
谶	讠	韱	# G
谼	谷	共	# GHTKP
谿	奚	谷	# GHTJKPV
豁	害	谷	# GHTK
豇	豆	工	# GHTJKP
豉	豆	支	# GHTJKPV
豌	豆	宛	# GHTJKP
豨	豕	希	# GHTJKP
豫	予	象	# GHTJKPV
豮	豕	贲	# G
豺	豸	才	# GHTJKPV
貂	豸	召	# GHTJKPV
貅	豸	休	# GHTJKPV
貆	豸	亘	# GHTJKP
貉	豸	各	# GHTJKPV
貊	豸	百	# GHTJKPV
貔	豸	𣬉	# GHTJKP
貘	豸	莫	# GHTJKP
财	贝	才	# G
败	贝	攵	# G
账	贝	长	# G
贩	贝	反	# G
贬	贝	乏	# G
购	贝	勾	# G
贮	贝	㝉	# G
贱	贝	戋	# G
贴	贝	占	# G
贶	贝	兄	# G
贻	贝	台	# G
贼	贝	戎	# G
贿	贝	有	# G
赂	贝	各	# G
赃	贝	庄	# G
赅	贝	亥	# G
赆	贝	尽	# G
赇	贝	求	# G
赈	贝	辰	# G
赊	贝	佘	# G
赋	贝	武	# G
赌	贝	者	# G
赎	贝	卖	# G
赐	贝	易	# G
赒	贝	周	# G
赔	贝	咅	# G
赕	贝	炎	# G
赖	束	负	# G
赗	贝	冒	# G
赙	贝	尃	# G
赚	贝	兼	# G
赜	𦣞	责	# G
赠	贝	曾	# G
赡	贝	詹	# G
赧	赤	𠬝	# GHTV
赧	赤	㞋	# JKP
赪	赤	贞	# G
赭	赤	者	# GHTKPV
趴	𧾷	八	# GHTK
趵	𧾷	勺	# GHTKP
趺	𧾷	夫	# GHTJKP
趼	𧾷	开	# GHTKP
趼	𧾷	幵	# J
趾	𧾷	止	# GHTJKPV
趿	𧾷	及	# GHTKPV
跂	𧾷	支	# GHTJKP
跃	𧾷	夭	# GHT
跄	𧾷	仓	# G
跆	𧾷	台	# GHTJKP
跋	𧾷	犮	# GHTJKP
跌	𧾷	失	# GHTJKPV
跎	𧾷	它	# GHTJKP
跏	𧾷	加	# GHTJKP
跐	𧾷	此	# GHTKP
跑	𧾷	包	# GHTKP
跖	𧾷	石	# GHTJKP
跗	𧾷	付	# GHTJKP
跚	𧾷	册	# GKP
跚	𧾷	冊	# HTJ
跛	𧾷	皮	# GHTJKP
跞	𧾷	乐	# G
跟	𧾷	艮	# GHTJKPV
跣	𧾷	先	# GHTJKP
跤	𧾷	交	# GHTJKP
跪	𧾷	危	# GHTJKPV
跬	𧾷	圭	# GHTJKPV
跱	𧾷	寺	# GHTJKP
跶	𧾷	达	# G
跷	𧾷	尧	# G
跸	𧾷	毕	# G
跹	𧾷	迁	# G
跺	𧾷	朵	# GHT
跻	𧾷	齐	# G
跽	𧾷	忌	# GHTJKP
踉	𧾷	良	# GHTJKP
踌	𧾷	寿	# GJ
踒	𧾷	委	# GHTKP
踔	𧾷	卓	# GHTJKPV
踝	𧾷	果	# GHTJKP
踞	𧾷	居	# GHTJKP
踟	𧾷	知	# GHTJKP
踢	𧾷	易	# GHTJKP
踣	𧾷	咅	# GHTJKPV
踦	𧾷	奇	# GHTJKP
踩	𧾷	采	# GHTKP
踪	𧾷	宗	# GHTJKPV
踬	𧾷	质	# G
踮	𧾷	店	# GHTK
踯	𧾷	郑	# G
踱	𧾷	度	# GHTJKP
踵	𧾷	重	# GHTJKP
踶	𧾷	是	# GHTJKP
踹	𧾷	耑	# GHTJKP
踺	𧾷	建	# GHTP
踽	𧾷	禹	# GHTJKP
蹀	𧾷	枼	# GHTJKPV
蹁	𧾷	扁	# GHTJKP
蹂	𧾷	柔	# GHTJKP
蹅	𧾷	查	# GHTP
蹈	𧾷	舀	# GHTJKPV
蹉	𧾷	差	# GHTJKPV
蹊	𧾷	奚	# GHTJKP
蹋	𧾷	𦐇	# GHTKP
蹐	𧾷	脊	# GHTJKP
蹑	𧾷	聂	# GTP
蹒	𧾷	𬜯	# G
蹓	𧾷	留	# GHT
蹚	𧾷	堂	# GHTK
蹜	𧾷	宿	# GHTJKPV
蹢	𧾷	啇	# GHTJKPV
蹦	𧾷	崩	# GHTK
蹬	𧾷	登	# GHTJKPV
蹭	𧾷	曾	# GHTJKP
蹯	𧾷	番	# GHTJKP
蹰	𧾷	厨	# GTJKP
蹲	𧾷	尊	# GHTJKP
蹶	𧾷	厥	# GHTJKP
蹼	𧾷	菐	# GHTJKP
蹽	𧾷	尞	# GV
蹾	𧾷	敦	# GHV
蹿	𧾷	窜	# G
躁	𧾷	喿	# GHTJKPV
躅	𧾷	蜀	# GHTJKPV
躇	𧾷	著	# GHTJKPV
躏	𧾷	蔺	# G
躐	𧾷	巤	# GHTJKPV
躔	𧾷	廛	# GHTJKPV
躜	𧾷	赞	# G
躞	𧾷	燮	# GHTJKP
躬	身	弓	# GHTJKPV
躲	身	朵	# GHTP
躺	身	尚	# GHTJV
躺	身	尙	# KP
轧	车	乚	# GH
轨	车	九	# G
轩	车	干	# G
轪	车	大	# G
轫	车	刃	# G
转	车	专	# G
轭	车	厄	# G
轮	车	仑	# GH
软	车	欠	# G
轱	车	古	# G
轲	车	可	# G
轳	车	卢	# G
轴	车	由	# G
轵	车	只	# G
轶	车	失	# G
轷	车	乎	# G
轸	车	㐱	# G
轹	车	乐	# G
轺	车	召	# G
轻	车	𢀖	# G
轼	车	式	# G
轾	车	至	# G
轿	车	乔	# G
辀	车	舟	# G
辁	车	全	# G
辂	车	各	# G
较	车	交	# G
辄	车	𦔮	# G
辅	车	甫	# G
辆	车	两	# G
辉	光	军	# G
辊	车	昆	# G
辋	车	罔	# G
辌	车	京	# G
辍	车	叕	# G
辎	车	甾	# G
辏	车	奏	# G
辐	车	畐	# G
辑	车	咠	# G
辒	车	昷	# G
输	车	俞	# GH
辕	车	袁	# G
辖	车	害	# G
辗	车	展	# G
辘	车	鹿	# G
辙	车	𰕎	# G
辚	车	粦	# G
辟	𡰪	辛	# GHTJKPV
辣	辛	束	# GHTJKPV
邓	又	阝	# GT
邗	干	阝	# GHTJKP
邘	于	阝	# GHTJKP
邙	亡	阝	# GHTJKPV
邛	工	阝	# GHTJKP
邝	广	阝	# G
邠	分	阝	# GHTJKP
邡	方	阝	# GHTJKP
邢	开	阝	# GHTJKP
邨	屯	阝	# GHMTJKP
邬	乌	阝	# G
邮	由	阝	# GHT
邯	甘	阝	# GHTJKP
邰	台	阝	# GHTJKP
邱	丘	阝	# GHTJKP
邲	必	阝	# GHTJKP
邳	丕	阝	# GHTJKP
邴	丙	阝	# GHTJKP
邵	召	阝	# GHTJKP
邶	北	阝	# GHTJKP
邹	刍	阝	# GT
邺	业	阝	# G
邻	令	阝	# G
邽	圭	阝	# GHTJKP
邾	朱	阝	# GHTJKPV
邿	寺	阝	# GHTKP
郃	合	阝	# GHTJKP
郄	𠫤	阝	# GHTJKP
郅	至	阝	# GHTJKP
郇	旬	阝	# GHTJKP
郈	后	阝	# GHTJKP
郏	夹	阝	# G
郐	会	阝	# G
郑	关	阝	# G
郓	军	阝	# G
郗	希	阝	# GHTJKP
郚	吾	阝	# GHTKP
郛	孚	阝	# GHTJKP
郜	告	阝	# GTKP
郜	吿	阝	# HJ
郝	赤	阝	# GHTJKP
郢	呈	阝	# GHTJKP
郤	谷	阝	# GHTJKP
郦	丽	阝	# G
郧	员	阝	# G
郪	妻	阝	# GHTKP
郫	卑	阝	# GHTKP
郯	炎	阝	# GHTJKP
郴	林	阝	# GHTJKP
郸	单	阝	# G
郾	匽	阝	# GHTJKP
郿	眉	阝	# GHTJKP
鄀	若	阝	# GHTJKP
鄂	咢	阝	# GHTJK
鄃	俞	阝	# GHT
鄃	兪	阝	# KP
鄄	垔	阝	# GHTJK
鄅	禹	阝	# GHTJKP
鄌	唐	阝	# GT
鄑	晋	阝	# G
鄑	晉	阝	# HTKP
鄗	高	阝	# GHTJKP
鄘	庸	阝	# GHTJKP
鄙	啚	阝	# GHTJKPV
鄚	莫	阝	# GHTJKP
鄜	鹿	阝	# GHTJKP
鄞	堇	阝	# GHTJKP
鄠	雩	阝	# GHTJKP
鄢	焉	阝	# GHTJKP
鄣	章	阝	# GHTJKP
鄫	曾	阝	# GHTKP
鄯	善	阝	# GHTJKP
鄱	番	阝	# GHTJKP
鄹	聚	阝	# GHTJKP
酂	赞	阝	# G
酃	霝	阝	# GHTJKP
酅	巂	阝	# GHTKP
酆	豐	阝	# GHTJKP
酊	酉	丁	# GHTJKP
酏	酉	也	# GHTJKP
酐	酉	干	# GHTK
酗	酉	凶	# GHTJKPV
酚	酉	分	# GHTJK
酝	酉	云	# G
酞	酉	太	# GHT
酡	酉	它	# GHTJKP
酣	酉	甘	# GHTJKP
酤	酉	古	# GHTJKP
酥	酉	禾	# GHTJKP
酦	酉	发	# G
酩	酉	名	# GHTJKPV
酮	酉	同	# GHTKP
酯	酉	旨	# GHTK
酰	酉	先	# GHT
酲	酉	呈	# GHTJKPV
酴	酉	余	# GHTJKP
酶	酉	每	# GHMTKP
酹	酉	寽	# GHTJK
酺	酉	甫	# GHTJKP
酽	酉	严	# G
酾	酉	丽	# G
酿	酉	良	# G
醅	酉	咅	# GHTJKP
醉	酉	卒	# GHTJKPV
醋	酉	昔	# GHTJKP
醌	酉	昆	# GHT
醑	酉	胥	# GHTJKP
醚	酉	迷	# GHTKP
醛	酉	荃	# GHTKP
醢	酉	𥁓	# GHTJKP
醣	酉	唐	# GHTK
醨	酉	离	# GHTJKP
醪	酉	翏	# GHTJKP
醭	酉	菐	# GHTJKP
醮	酉	焦	# GHTJKP
醴	酉	豊	# GHTJKP
醵	酉	豦	# GHTJKP
醺	酉	熏	# GHTJKP
醾	酉	糜	# GHTKPV
釉	釆	由	# GJKP
釉	采	由	# HT
释	釆	𠬤	# G
钆	钅	乚	# G
钇	钅	乙	# G
针	钅	十	# G
钉	钅	丁	# G
钊	钅	刂	# G
钋	钅	卜	# G
钌	钅	了	# G
钍	钅	土	# G
钎	钅	千	# G
钏	钅	川	# G
钐	钅	彡	# G
钒	钅	凡	# G
钓	钅	勺	# G
钔	钅	门	# G
钕	钅	女	# G
钖	钅	𠃓	# G
钗	钅	叉	# G
钘	钅	开	# G
钙	钅	丐	# G
钚	钅	不	# G
钛	钅	太	# G
钜	钅	巨	# G
钝	钅	屯	# G
钞	钅	少	# G
钟	钅	中	# GH
钠	钅	内	# G
钡	钅	贝	# G
钢	钅	冈	# GH
钣	钅	反	# G
钤	钅	今	# G
钥	钅	月	# G
钦	钅	欠	# G
钧	钅	匀	# G
钨	钅	乌	# G
钩	钅	勾	# G
钪	钅	亢	# G
钫	钅	方	# G
钬	钅	火	# G
钭	钅	斗	# G
钮	钅	丑	# G
钯	钅	巴	# G
钰	钅	玉	# G
钱	钅	戋	# G
钲	钅	正	# G
钳	钅	甘	# G
钴	钅	古	# G
钵	钅	本	# G
钶	钅	可	# G
钷	钅	叵	# G
钸	钅	布	# G
钹	钅	犮	# G
钺	钅	戉	# G
钻	钅	占	# G
钼	钅	目	# G
钽	钅	旦	# G
钾	钅	甲	# G
钿	钅	田	# G
铀	钅	由	# G
铁	钅	失	# GH
铂	钅	白	# G
铃	钅	令	# G
铄	钅	乐	# G
铆	钅	卯	# G
铈	钅	市	# G
铉	钅	玄	# G
铊	钅	它	# G
铋	钅	必	# G
铌	钅	尼	# G
铍	钅	皮	# G
铎	钅	𠬤	# G
铏	钅	刑	# G
铐	钅	考	# G
铑	钅	老	# G
铒	钅	耳	# G
铕	钅	有	# G
铖	钅	成	# G
铗	钅	夹	# G
铘	钅	邪	# G
铙	钅	尧	# G
铚	钅	至	# G
铛	钅	当	# G
铜	钅	同	# GH
铝	钅	吕	# G
铞	钅	吊	# G
铟	钅	因	# G
铠	钅	岂	# G
铡	钅	则	# G
铢	钅	朱	# G
铣	钅	先	# G
铤	钅	廷	# G
铥	钅	丢	# G
铧	钅	华	# G
铨	钅	全	# G
铩	钅	杀	# G
铪	钅	合	# G
铫	钅	兆	# G
铬	钅	各	# G
铭	钅	名	# G
铮	钅	争	# G
铯	钅	色	# G
铰	钅	交	# G
铱	钅	衣	# G
铲	钅	产	# G
铳	钅	充	# G
铴	钅	汤	# G
铵	钅	安	# G
银	钅	艮	# GH
铷	钅	如	# G
铸	钅	寿	# G
铹	钅	劳	# G
铺	钅	甫	# G
铻	钅	吾	# G
铼	钅	来	# G
铽	钅	忒	# G
链	钅	连	# G
铿	钅	坚	# G
销	钅	肖	# G
锁	钅	𭕆	# G
锂	钅	里	# G
锃	钅	呈	# G
锄	钅	助	# G
锅	钅	呙	# G
锆	钅	告	# G
锇	钅	我	# G
锈	钅	秀	# G
锉	钅	坐	# G
锊	钅	寽	# G
锋	钅	夆	# G
锌	钅	辛	# G
锍	钅	㐬	# G
锎	钅	𫔭	# G
锏	钅	间	# G
锐	钅	兑	# G
锑	钅	弟	# G
锒	钅	良	# G
锓	钅	𠬶	# G
锔	钅	局	# G
锕	钅	阿	# G
锖	钅	青	# G
锗	钅	者	# G
锘	钅	若	# G
错	钅	昔	# G
锚	钅	苗	# G
锛	钅	奔	# G
锜	钅	奇	# G
锝	钅	㝵	# G
锞	钅	果	# G
锟	钅	昆	# G
锡	钅	易	# G
锢	钅	固	# G
锣	钅	罗	# G
锤	钅	垂	# G
锥	钅	隹	# G
锦	钅	帛	# G
锧	钅	质	# G
锨	钅	欣	# G
锩	钅	卷	# G
锪	钅	忽	# G
锫	钅	咅	# G
锬	钅	炎	# G
锭	钅	定	# GH
键	钅	建	# G
锯	钅	居	# G
锰	钅	孟	# G
锱	钅	甾	# G
锲	钅	契	# G
锳	钅	英	# G
锴	钅	皆	# G
锵	钅	将	# G
锶	钅	思	# G
锷	钅	咢	# G
锸	钅	臿	# G
锹	钅	秋	# G
锺	钅	重	# G
锻	钅	段	# G
锼	钅	叟	# G
锽	钅	皇	# G
锾	钅	爰	# G
锿	钅	哀	# G
镀	钅	度	# G
镁	钅	美	# G
镂	钅	娄	# G
镃	钅	兹	# G
镄	钅	费	# G
镅	钅	眉	# G
镆	钅	莫	# G
镇	钅	真	# GH
镈	钅	尃	# G
镉	钅	鬲	# G
镊	钅	聂	# G
镋	钅	党	# G
镌	钅	隽	# G
镍	钅	臬	# G
镎	钅	拿	# G
镏	钅	留	# G
镐	钅	高	# G
镑	钅	旁	# G
镒	钅	益	# G
镓	钅	家	# G
镔	钅	宾	# G
镕	钅	容	# G
镖	钅	票	# G
镗	钅	堂	# G
镘	钅	曼	# G
镙	钅	累	# G
镚	钅	崩	# G
镛	钅	庸	# G
镜	钅	竟	# G
镝	钅	啇	# G
镞	钅	族	# G
镟	钅	旋	# G
镠	钅	翏	# G
镡	钅	覃	# G
镢	钅	厥	# G
镣	钅	尞	# G
镤	钅	菐	# G
镥	钅	鲁	# G
镦	钅	敦	# G
镧	钅	阑	# G
镨	钅	普	# G
镩	钅	窜	# G
镪	钅	强	# G
镫	钅	登	# G
镬	钅	蒦	# G
镭	钅	雷	# G
镮	钅	睘	# G
镯	钅	蜀	# G
镰	钅	廉	# G
镱	钅	意	# G
镲	钅	察	# G
镳	钅	麃	# G
镴	钅	巤	# G
镵	钅	毚	# G
镶	钅	襄	# G
队	阝	人	# G
阡	阝	千	# GHTJKP
阢	阝	兀	# GHTJKP
阮	阝	元	# GHTJKPV
阱	阝	井	# GHTJKP
阳	阝	日	# GHTJP
阴	阝	月	# GTJP
阵	阝	车	# G
阶	阝	介	# G
阼	阝	乍	# GHTJKP
阽	阝	占	# GHTJKP
陂	阝	皮	# GHTJKPV
际	阝	示	# GH
陆	阝	击	# G
陇	阝	龙	# G
陈	阝	东	# G
陉	阝	𢀖	# G
陋	阝	𫠥	# GHTJKPV
陌	阝	百	# GHTJKPV
陎	阝	朱	# GHTK
陑	阝	而	# GHTKP
陔	阝	亥	# GHTJKP
陕	阝	夹	# GTKP
陞	阝	𡉼	# GHTJKPV
陟	阝	步	# GHTJKP
陡	阝	走	# GHTJKP
陧	阝	圼	# G
陨	阝	员	# G
险	阝	佥	# GH
陬	阝	取	# GHTKP
陲	阝	垂	# GHTJKPV
陴	阝	卑	# GHTKP
陷	阝	臽	# GHTJKPV
隃	阝	俞	# GHT
隃	阝	兪	# JK
隍	阝	皇	# GHTJKPV
隐	阝	急	# G
隗	阝	鬼	# GHTJKP
隘	阝	益	# GHTJKPV
隧	阝	遂	# GHTKP
隩	阝	奥	# G
隩	阝	奧	# HTJKP
隰	阝	㬎	# GHTJKPV
难	又	隹	# GTV
雉	矢	隹	# GHTJKPV
雊	句	隹	# GHTJKP
雎	且	隹	# GHTJKP
雏	刍	隹	# GT
雒	各	隹	# GHTJKP
雕	周	隹	# GHTKPV
靓	青	见	# G
靛	青	定	# GHT
靛	靑	定	# JKP
靬	革	干	# GHTKP
靰	革	兀	# GHTK
靳	革	斤	# GHTJKPV
靶	革	巴	# GHTJK
靸	革	及	# GHTJKP
靺	革	末	# GHTJKP
靼	革	旦	# GHTJKP
靽	革	半	# GHTKP
靿	革	幼	# GHTJKP
鞁	革	皮	# GHTJKP
鞅	革	央	# GHTJKPV
鞋	革	圭	# GHTJKPV
鞑	革	达	# G
鞒	革	乔	# G
鞔	革	免	# GHTKP
鞡	革	拉	# GHTK
鞣	革	柔	# GHTJKP
鞧	革	酋	# GTP
鞨	革	曷	# GHTJKP
鞫	革	訇	# GHTJKP
鞬	革	建	# GHTJKP
鞮	革	是	# GHTJKP
鞯	革	荐	# G
鞲	革	冓	# GHTJKP
鞳	革	荅	# GHTJKP
鞴	革	𤰇	# GHTJKP
韂	革	詹	# GHTKP
韧	韦	刃	# G
韨	韦	犮	# G
韩	𠦝	韦	# G
韫	韦	昷	# G
韬	韦	舀	# G
韵	音	匀	# GPV
韵	音	勻	# HTJK
韶	音	召	# GHTJKPV
顶	丁	页	# G
顷	匕	页	# G
顸	干	页	# G
项	工	页	# G
顺	川	页	# G
须	彡	页	# G
顼	𤣩	页	# G
顽	元	页	# G
顾	厄	页	# G
顿	屯	页	# G
颀	斤	页	# G
颁	分	页	# G
颂	公	页	# G
颃	亢	页	# G
预	予	页	# G
颅	卢	页	# G
领	令	页	# G
颇	皮	页	# G
颈	𢀖	页	# G
颉	吉	页	# G
颊	夹	页	# G
颋	廷	页	# G
颌	合	页	# G
颎	𭴁	页	# G
颏	亥	页	# G
颐	𦣞	页	# G
频	步	页	# G
颓	秃	页	# G
颔	含	页	# G
颗	果	页	# G
颙	禺	页	# G
颚	咢	页	# G
颛	耑	页	# G
颜	彦	页	# G
额	客	页	# G
颞	聂	页	# G
颟	𬜯	页	# G
颠	真	页	# G
颡	桑	页	# G
颢	景	页	# G
颤	亶	页	# G
颥	需	页	# G
颧	雚	页	# G
飒	立	风	# G
飘	票	风	# G
飙	猋	风	# G
飞	⺄	？	# G
飞	⺄	𡿨	# H
飧	夕	食	# GHTJKP
飨	乡	食	# G
饥	饣	几	# G
饧	饣	𠃓	# G
饨	饣	屯	# G
饩	饣	气	# G
饪	饣	壬	# G
饫	饣	夭	# G
饬	饣	𱐩	# G
饭	饣	反	# G
饮	饣	欠	# G
饯	饣	戋	# G
饱	饣	包	# G
饲	饣	司	# G
饳	饣	出	# G
饴	饣	台	# G
饵	饣	耳	# G
饶	饣	尧	# G
饷	饣	向	# G
饸	饣	合	# G
饹	饣	各	# G
饺	饣	交	# G
饻	饣	衣	# G
饼	饣	并	# G
饽	饣	孛	# G
饿	饣	我	# G
馀	饣	余	# GM
馁	饣	妥	# G
馃	饣	果	# G
馄	饣	昆	# G
馅	饣	臽	# G
馆	饣	官	# G
馇	饣	查	# G
馈	饣	贵	# G
馉	饣	骨	# G
馊	饣	叟	# G
馋	饣	𫥎	# G
馌	饣	盍	# G
馍	饣	莫	# G
馏	饣	留	# G
馐	饣	羞	# G
馑	饣	堇	# G
馒	饣	曼	# G
馓	饣	散	# G
馔	饣	巽	# G
馕	饣	囊	# G
馘	首	或	# GHTJKP
馝	香	必	# GHTJKP
馞	香	孛	# GHTJKP
馥	香	复	# GHTJKPV
馧	香	昷	# G
馧	香	𥁕	# HTKP
驭	马	又	# G
驮	马	大	# G
驯	马	川	# G
驰	马	也	# G
驱	马	区	# G
驲	马	日	# G
驳	马	爻	# G
驴	马	户	# G
驵	马	且	# G
驶	马	史	# G
驷	马	四	# G
驸	马	付	# G
驹	马	句	# G
驺	马	刍	# G
驻	马	主	# G
驼	马	它	# G
驿	马	𠬤	# G
骀	马	台	# G
骁	马	尧	# G
骃	马	因	# G
骄	马	乔	# G
骅	马	华	# G
骆	马	各	# G
骇	马	亥	# G
骈	马	并	# G
骊	马	丽	# G
骋	马	甹	# G
验	马	佥	# G
骍	马	辛	# G
骎	马	𠬶	# G
骏	马	夋	# G
骐	马	其	# G
骑	马	奇	# G
骒	马	果	# G
骓	马	隹	# G
骕	马	肃	# G
骖	马	参	# G
骗	马	扁	# G
骙	马	癸	# G
骚	马	蚤	# G
骝	马	留	# G
骟	马	扇	# G
骠	马	票	# G
骡	马	累	# G
骢	马	悤	# G
骣	马	孱	# G
骤	马	聚	# G
骥	马	冀	# G
骦	马	霜	# G
骧	马	襄	# G
骰	骨	殳	# GHTJKP
骱	骨	介	# GHTKP
骶	骨	氐	# GHTJKP
骷	骨	古	# GHTJKP
骺	骨	后	# GHTKP
骼	骨	各	# GHTJKP
髀	骨	卑	# GHTKP
髁	骨	果	# GHTJKP
髂	骨	客	# GHTKP
髃	骨	禺	# GTJKP
髅	骨	娄	# GV
髋	骨	宽	# G
髌	骨	宾	# G
髎	骨	翏	# GTJKP
髑	骨	蜀	# GHTJKP
髓	骨	遀	# GHTJKPV
髟	镸	彡	# GHTJKP
鬷	鬲	㚇	# GHTJKP
魄	白	鬼	# GHTJKPV
魏	委	鬼	# GHTJKPV
鱽	鱼	刀	# G
鱾	鱼	己	# G
鱿	鱼	尤	# G
鲀	鱼	屯	# G
鲂	鱼	方	# G
鲃	鱼	巴	# G
鲅	鱼	犮	# G
鲆	鱼	平	# G
鲇	鱼	占	# G
鲈	鱼	卢	# G
鲉	鱼	由	# G
鲊	鱼	乍	# G
鲋	鱼	付	# G
鲌	鱼	白	# G
鲍	鱼	包	# G
鲏	鱼	皮	# G
鲐	鱼	台	# G
鲑	鱼	圭	# G
鲒	鱼	吉	# G
鲔	鱼	有	# G
鲕	鱼	而	# G
鲖	鱼	同	# G
鲗	鱼	则	# G
鲘	鱼	后	# G
鲙	鱼	会	# G
鲚	鱼	齐	# G
鲛	鱼	交	# G
鲜	鱼	羊	# G
鲟	鱼	寻	# G
鲠	鱼	更	# G
鲡	鱼	丽	# G
鲢	鱼	连	# G
鲣	鱼	坚	# G
鲤	鱼	里	# G
鲥	鱼	时	# G
鲦	鱼	条	# G
鲧	鱼	系	# G
鲩	鱼	完	# G
鲪	鱼	君	# G
鲫	鱼	即	# G
鲬	鱼	甬	# G
鲭	鱼	青	# G
鲮	鱼	夌	# G
鲯	鱼	其	# G
鲰	鱼	取	# G
鲱	鱼	非	# G
鲲	鱼	昆	# G
鲳	鱼	昌	# G
鲴	鱼	固	# G
鲵	鱼	兒	# G
鲶	鱼	念	# G
鲷	鱼	周	# G
鲸	鱼	京	# G
鲹	鱼	参	# G
鲺	鱼	虱	# G
鲻	鱼	甾	# G
鲼	鱼	贲	# G
鲽	鱼	枼	# G
鲾	鱼	畐	# G
鲿	鱼	尝	# G
鳀	鱼	是	# G
鳁	鱼	昷	# G
鳂	鱼	畏	# G
鳃	鱼	思	# G
鳄	鱼	咢	# G
鳅	鱼	秋	# G
鳆	鱼	复	# G
鳇	鱼	皇	# G
鳈	鱼	泉	# G
鳉	鱼	将	# G
鳊	鱼	扁	# G
鳋	鱼	蚤	# G
鳍	鱼	耆	# G
鳎	鱼	𦐇	# G
鳏	鱼	眔	# G
鳐	鱼	䍃	# G
鳑	鱼	旁	# G
鳒	鱼	兼	# G
鳓	鱼	勒	# G
鳔	鱼	票	# G
鳕	鱼	雪	# G
鳗	鱼	曼	# G
鳙	鱼	庸	# G
鳚	鱼	尉	# G
鳛	鱼	習	# G
鳜	鱼	厥	# G
鳝	鱼	善	# G
鳞	鱼	粦	# G
鳟	鱼	尊	# G
鳠	鱼	蒦	# G
鳡	鱼	感	# G
鳢	鱼	豊	# G
鳣	鱼	亶	# G
鳤	鱼	管	# G
鸠	九	鸟	# G
鸡	又	鸟	# G
鸣	口	鸟	# G
鸤	尸	鸟	# G
鸥	区	鸟	# G
鸦	牙	鸟	# G
鸧	仓	鸟	# G
鸨	𠤏	鸟	# G
鸩	冘	鸟	# G
鸪	古	鸟	# G
鸫	东	鸟	# G
鸬	卢	鸟	# G
鸭	甲	鸟	# G
鸮	号	鸟	# G
鸰	令	鸟	# G
鸱	氐	鸟	# G
鸲	句	鸟	# G
鸵	鸟	它	# G
鸸	而	鸟	# G
鸹	舌	鸟	# G
鸺	休	鸟	# G
鸻	行	鸟	# G
鸼	舟	鸟	# G
鸽	合	鸟	# G
鸿	江	鸟	# G
鹀	巫	鸟	# G
鹁	孛	鸟	# G
鹂	丽	鸟	# G
鹃	肙	鸟	# G
鹄	告	鸟	# G
鹅	我	鸟	# G
鹆	谷	鸟	# G
鹇	闲	鸟	# G
鹈	弟	鸟	# G
鹉	武	鸟	# G
鹊	昔	鸟	# G
鹋	苗	鸟	# G
鹌	奄	鸟	# G
鹍	昆	鸟	# G
鹎	卑	鸟	# G
鹏	朋	鸟	# G
鹐	臽	鸟	# G
鹑	享	鸟	# G
鹒	庚	鸟	# G
鹔	肃	鸟	# G
鹕	胡	鸟	# G
鹖	曷	鸟	# G
鹗	咢	鸟	# G
鹘	骨	鸟	# G
鹚	兹	鸟	# G
鹛	眉	鸟	# G
鹝	鬲	鸟	# G
鹞	䍃	鸟	# G
鹟	翁	鸟	# G
鹠	留	鸟	# G
鹡	脊	鸟	# G
鹢	益	鸟	# G
鹣	兼	鸟	# G
鹤	隺	鸟	# G
鹦	婴	鸟	# G
鹧	庶	鸟	# G
鹨	翏	鸟	# G
鹩	尞	鸟	# G
鹪	焦	鸟	# G
鹬	矞	鸟	# G
鹮	睘	鸟	# G
鹯	亶	鸟	# G
鹱	鸟	蒦	# G
鹲	蒙	鸟	# G
鹳	雚	鸟	# G
鹴	霜	鸟	# G
鹾	卤	差	# G
麒	鹿	其	# GHTJKPV
麴	麥	匊	# GP
麸	麦	夫	# G
黇	黄	占	# G
黇	黃	占	# HTP
黏	黍	占	# GHTJKPV
黔	黑	今	# GHTJKP
默	黑	犬	# GHTJKPV
黜	黑	出	# GHTJKPV
黝	黑	幼	# GHTJKP
黟	黑	多	# GHTJKP
黠	黑	吉	# GHTJKP
黢	黑	夋	# GHTKP
黥	黑	京	# GHTJKPV
黩	黑	卖	# G
黪	黑	参	# G
黯	黑	音	# GHTJKPV
黻	黹	犮	# GHTJK
黼	黹	甫	# GHTJKP
鼢	鼠	分	# GJP
鼩	鼠	句	# GP
鼫	鼠	石	# GP
鼬	鼠	由	# GP
鼯	鼠	吾	# GP
鼱	鼠	青	# GP
鼱	鼠	靑	# JK
鼷	鼠	奚	# GP
鼹	鼠	晏	# GP
鼽	鼻	九	# GHTKP
鼾	鼻	干	# GHTKP
齁	鼻	句	# GHTKP
齄	鼻	查	# GH
齄	鼻	査	# TKP
齇	鼻	虘	# GHTKP
齉	鼻	囊	# GHTK
龀	齿	𠤎	# G
龁	齿	乞	# G
龂	齿	斤	# G
龃	齿	且	# G
龄	齿	令	# G
龅	齿	包	# G
龆	齿	召	# G
龇	齿	此	# G
龈	齿	艮	# G
龉	齿	吾	# G
龊	齿	足	# G
龋	齿	禹	# G
龌	齿	屋	# G
龢	龠	禾	# GHTJKP
鿍	土	夅	# GU
鿎	石	达	# G
鿏	钅	麦	# GU
㑇	亻	刍	# G
㑊	亻	亦	# GHTKP
㕮	口	父	# GTJP
㘎	口	阚	# G
㙍	土	叕	# GT
㙘	土	要	# GV
㛚	女	甬	# GT
㛹	女	便	# GTP
㟃	山	司	# GTK
㠓	山	蒙	# GT
㤘	忄	刍	# G
㥄	忄	夌	# GTP
㧐	扌	双	# G
㧑	扌	为	# G
㧟	扌	汇	# G
㫰	日	良	# GHTKPV
㬚	日	𰕎	# GTJKP
㭎	木	冈	# G
㭕	木	去	# GTJP
㰀	木	黎	# GT
㳇	氵	父	# GT
㳘	氵	充	# GTKP
㳚	氵	戍	# GTJP
㴔	氵	急	# GTP
㵐	氵	厥	# GT
㶲	火	用	# GT
㸆	火	靠	# GH
㸌	火	霍	# GT
㺄	犭	俞	# GT
㺄	犭	兪	# K
㻬	𤣩	雩	# GHT
㿠	白	光	# GK
䁖	目	娄	# G
䃅	石	单	# G
䃎	石	奓	# GTP
䅟	禾	参	# G
䌹	纟	冋	# G
䎃	冉	羽	# GTP
䎖	曾	羽	# GTKP
䏝	月	专	# G
䏡	月	示	# G
䏡	⺼	示	# T
䏲	月	弟	# G
䏲	⺼	弟	# HT
䐃	月	囷	# GKP
䐃	⺼	囷	# T
䗖	虫	带	# G
䗛	虫	脩	# GT
䗴	虫	筳	# GT
䜣	讠	斤	# G
䝙	豸	区	# G
䢺	出	阝	# G
䢼	共	阝	# GT
䣘	堂	阝	# GT
䥽	钅	发	# G
䦃	钅	著	# G
䲟	鱼	印	# G
䲠	鱼	春	# G
䲢	月	鲞	# G
䴓	帀	鸟	# G
䴔	交	鸟	# G
䴖	青	鸟	# G
䴗	狊	鸟	# G
䴘	虒	鸟	# G
䴙	辟	鸟	# G
𠳐	口	邦	# GV
𡎚	土	扁	# GT
𡐓	土	康	# GHT
𣗋	木	党	# G
𣲗	氵	韦	# G
𣲘	氵	无	# G
𣸣	氵	贲	# GV
𤧛	𤣩	帝	# G
𤩽	𤣩	献	# GTV
𤫉	𤣩	燮	# GTP
𥔲	石	咢	# GT
𥕢	石	曹	# GH
𥖨	石	喿	# G
𥻗	米	查	# GHU
𦈡	纟	需	# G
𦒍	童	羽	# GHTP
𦙶	月	古	# GPV
𦙶	⺼	古	# T
𦝼	月	娄	# GV
𦝼	⺼	娄	# T
𧿹	𧾷	母	# GHTPV
𨐈	车	光	# G
𨙸	支	阝	# GTP
𨚕	弁	阝	# GT
𨟠	瞿	阝	# GT
𨱇	钅	求	# G
𨱏	钅	荅	# G
𨱑	钅	黄	# G
𨱔	钅	尊	# G
𨺙	阝	兒	# G
𩽾	鱼	安	# GV
𩾃	鱼	免	# G
𩾌	鱼	康	# GV
𪟝	责	力	# G
𪣻	土	娄	# GT
𪤗	土	翏	# GT
𪨰	山	曲	# GT
𪩘	山	献	# G
𪾢	目	见	# GU
𫄧	纟	延	# G
𫄨	纟	希	# GU
𫄷	纟	意	# G
𫄸	纟	熏	# GU
𫌀	衤	责	# GU
𫍣	讠	同	# G
𫍯	讠	咸	# G
𫍲	讠	叟	# G
𫍽	讠	睘	# G
𫐄	车	兀	# GU
𫐐	车	兒	# GU
𫐓	车	柔	# GU
𫑡	黾	阝	# G
𫓧	钅	夫	# GU
𫓯	钅	圭	# G
𫓶	钅	肙	# G
𫓹	钅	其	# G
𫔍	钅	番	# G
𫔎	钅	矞	# GU
𫖮	岂	页	# G
𫖯	兆	页	# GU
𫖳	君	页	# G
𫗧	饣	束	# GU
𫗴	饣	亶	# GU
𫘜	马	文	# GU
𫘝	马	夬	# GU
𫘦	马	匋	# G
𫘧	马	录	# G
𫘨	马	是	# GU
𫘪	马	原	# G
𫘬	马	奚	# G
𫚕	鱼	师	# GU
𫚭	鱼	巤	# G
𫞩	𤣩	𬜯	# G
𫟅	纟	京	# G
𫟦	车	遂	# G
𫟹	钅	共	# G
𫟼	钅	达	# G
𫠆	支	页	# G
𫠊	马	玄	# G
𫠜	齿	兒	# G
𫢸	亻	单	# G
𫫇	口	恶	# G
𫭟	土	区	# G
𫭢	土	仑	# G
𫭼	土	劳	# G
𫮃	土	单	# G
𫰛	女	𢀖	# G
𫵷	山	历	# GM
𫶇	山	带	# G
𫸩	弓	区	# G
𬀩	日	韦	# G
𬀪	日	见	# G
𬂩	木	夹	# G
𬃊	木	质	# G
𬇕	氵	万	# G
𬇙	氵	贝	# G
𬇹	氵	国	# G
𬉼	火	区	# G
𬊈	火	寻	# G
𬊤	火	单	# G
𬌗	牙	合	# GM
𬍛	𤣩	乐	# G
𬍤	𤣩	寻	# G
𬒔	石	肯	# GMU
𬒗	石	览	# G
𬘓	纟	川	# G
𬘘	纟	冘	# G
𬘡	纟	因	# G
𬘩	纟	廷	# G
𬘫	纟	完	# G
𬘬	纟	青	# G
𬘭	纟	林	# GU
𬘯	纟	享	# G
𬙂	纟	寅	# G
𬙊	纟	墨	# G
𬙋	纟	襄	# G
𬟽	虫	东	# G
𬣙	讠	于	# GU
𬣞	讠	㝉	# G
𬣡	讠	戋	# G
𬣳	讠	艮	# G
𬤇	讠	垔	# G
𬤊	讠	是	# G
𬤝	讠	惠	# G
𬨂	车	氏	# G
𬨎	车	酋	# GU
𬩽	寻	阝	# G
𬪩	酉	农	# GU
𬬩	钅	弋	# G
𬬭	钅	仑	# G
𬬮	钅	长	# G
𬬱	钅	斤	# G
𬬸	钅	术	# GU
𬬹	钅	申	# G
𬬻	钅	卢	# G
𬬿	钅	召	# G
𬭁	钅	母	# G
𬭊	钅	杜	# G
𬭎	钅	宏	# G
𬭚	钅	享	# G
𬭛	钅	波	# G
𬭤	钅	侯	# G
𬭩	钅	翁	# G
𬭬	钅	彗	# G
𬭯	钅	敝	# G
𬭳	钅	喜	# G
𬭶	钅	黑	# G
𬭸	钅	粦	# G
𬭼	钅	遂	# G
𬮿	阝	岂	# G
𬯀	阝	齐	# G
𬯎	阝	贵	# GU
𬱖	由	页	# G
𬱟	危	页	# G
𬳵	马	丕	# G
𬳶	马	冋	# G
𬳽	马	先	# G
𬳿	马	余	# G
𬴂	马	非	# G
𬴃	马	砉	# G
𬴊	马	粦	# G
𬶋	鱼	句	# G
𬶍	鱼	它	# G
𬶏	鱼	危	# G
𬶐	鱼	兆	# G
𬶟	鱼	剌	# G
𬶠	鱼	柬	# G
𬶭	鱼	祭	# G
𬶮	鱼	喜	# G
𬷕	甫	鸟	# GU
𬸘	匽	鸟	# G
𬸪	番	鸟	# G
𬹼	齿	介	# G
𬺈	齿	奇	# GU
𬺓	齿	楚	# G